G99999999
911111119
918181819
918315819
911111119
988888889
918181819
911111119
99999999M
