122133113111223311311233331331333123331313321111113331233221122233311232222311332111231131333122112G
1313212133122331212313211212312113113131132231223332331111112123232133222313133322213232223313331113
3213122122322112321123112233212122223221321232232231113123232211112331333322113313312321221332321331
1231111111122111122113132122112221321323213122211213131221212121131313333321113211221223212221131113
2311213212133123222131212313333311211122111131213331311133121212121223333112333122313221311221233311
3233113321321333232211131223313213212232222322213133231232322232332231222123111313133322131212122231
3231121313123113212232211322213212212112211121123333333231132132231322112131312233212212121212312121
3112133132132321322331213112121112133222112122213311212233132111223123321221221221233211121221331322
3213322312112332132123213122333112221221322231123232221321332221223323223232123121231133223223232212
3233222333213221211223312111233223112123122133331122131313211221123132121311331122313313221133312321
1113111211213113323332131122322313333323113123133111332112232211113231212322113122122331221331331223
3311322111131313333313223221113132111113111231133212223331233111311121333113223222211332113222232233
3312333112222122131131133321121333223312131213213231312122223213133331121231231122222123212312121211
1233123313313132313121122312312113331122231122231223232333122213231233222313232113231321321233313131
1112321133313233121311113321223312212132232333313222132113132113112312322322231131112221222232211311
3231323323231312313223122312122313231333113223223211323133322332323233312113221332231112121321113231
1321223231211131113133123233221313232112311112323131231131131332323323321222132232121332322212121231
1113212322113121211131222121112213231113133123333312323233333313222222231132331331231222112212132111
1221221323333232313113231121313323131232223131111313133131131121313122323313221223211313311232323122
2123322233313212113322213222131122232213112211232333323221133133321321221113233122123223122333331313
2133223321132231231213113223212323211112223121122331232232311211121132312312212211333211233132212121
2333221212122221233223211111212323122221231223332121112222221212312131222212111133323222211231113213
2323123122111222232213132112221231313123331332132131222111221221331132312322112221333123332331123221
3121212323212312323131111213232133232311222221331131331312223111321332231231132311133122331232311332
3222233331132323212321233221112131132221331222121131123332212111122112233122312132132312131323122121
3113133221322132122132111221121311312223213331312111211332222321323121231111212133113232322222322212
3311233212213133132212233223122322232223123221231123213322132313213223331313131312222321321112321112
2322321212312121233321123213211223321123321312232111322231231232213211121321133332313133322332132111
3122122122223222231121213123312231223323332323113232323322321321223121213112132231121222322322113211
2222331322112333132123211211222222132133233333212323121221332331212223322211321213322113331211123311
1332133313121113313312333111111332333112322123333311212333223123212212311323231311211213232113222221
2132132332113123331112222132122111132211123133132112322121323213111213222332311211221221131123313223
3222113133212311223133312133233223231112213333321123223111221223213333311223311332331233232333121213
1133133311233231222211323311213132233122312212121121321121231331122333322322221313233313213133212221
2231221111133313221132312221122212223212313122313232121213313321231112321332222322231322233131322212
2331112313322121331221221322313313333331133321321132313213212211113331132213221231131331212313323323
3332123132121122333131311121323211311111312331133212211221333223113323223111311312323311132211133313
3331313232121311211112333111112213221222212321132131121311213222111233212133123232133322313321132213
1212322123111231122321233213111121133223233132333121232222331233111212121322111313311111131111311113
2322113223212212121212111331333213322331113212333123123333321233222212223331131321133321231221133113
3131123112133112131131122112323221233133132123122223233233112331323113213223321313223332323232113323
3213323132232221313313311333133212111313212233312122233231131232222332121111233132222222132212232331
1131131332333332111333333322323331121332313333232321231212133313213112312333332223331232221132231121
3122112132121221313223112121213111212131133222312131212122331221222231133331231311311222232131311132
2133232223312222232113221131131312311323211322322323112213213212112122212312323311133313133322312123
2233223333323332213132332133311112311123123223322113323121213212222213321312121212131131211112311131
1321311211322211133331331112232323232231311313133331111232233331321313311213223331212113132211232332
3133212333312333232133212221323223213332311213122121231333233312133112232132121333132232233122223221
2331311322322131311212111212111323131313213331213313232111322121232322231231222223213332122212112221
3333222122133233222313113321133313131311113311222323212111133113312123112122321112221131113131333221
2311333131321123322133312211111221211331211123123221232133123321123323222233121131223233113233221223
2231122113111231132213311321231332211113331311132121111213112223222221231311133112321121233132212323
2322231113232232311232211323212332133112233221133112121211311233213111121222113233222111222321112111
3222222111313131133322113323312212312132233132122112233232333332222212113233323312211123323323223232
3122333112223212311223311212211212121121313112332222122113123322121331233331312111131231213231331111
2313231232321313312133321313123131222231333231311331122333222212231122331212322112322212211212233231
1333311332213321333212223331323211323321211312333222121132121232111322311221331323121121332213313213
1222213332313232133233132332131332111223213232131212332332333312211323123133133213221112322113211222
1133213321113331321221213313121133312222122132311331221323211231213221222332131111122321311211212222
3312212332212131113121113121111123321333332311333133112323221211321322211333233233123312123213322211
1332213111113213121321223113222122323333333212112112231223322212122133323333223111113331221322122211
3122312313323111131313313112223123112121121312311313333312132121113313121322112221333213232223233331
1332132232332211332223211233312233131311112121233133122123131221323133131311322111232131213112213313
2131132233321311312231222223321231213121131213322232122313223223323312113112113113331112321232232331
3232323323112121121221223211331322331132311212133132312231231232131212213311131112333122231122132233
2113222133333331113122322322322311133331131232211123133331311131233311331231113113231313131333331213
3311112222223211123123121223212213131213131222313322111132311223332321311233331123233122321211122321
2313123332312112123221223211113212322121223223232231132221112132133112112122322331322333111133132213
3321323221131123212212111331113122122322112213212111331233323131112132131212112332131211223332121333
2323312131313223331223311121132231222321122211233112221111133332132221213313123313331321132232313211
3222213313223313211231311313211232331131233231121313213111331123231322311222121233312213133222333321
2231232233112133133232333311232231331233232323112122212112212331131122313231332222213321113211321122
2121233311211112122113232223222132122221321311122133132122213321333323332131333121333212112313312113
1333221113211311123213312213122323223113332131131221213133323233323312132321312321121223122232312112
2331321132221223233133211111133233221331331211331332311231231332222213113223313233221323321321332212
3311132231212123312323322231312213331113233233333212313223133122233112313122132211112333231111313233
3231331112223213312331132333322133331332121122132132112133222323312123331312131222221222323232311331
2323223223323221232112331111111223333332122223313122111112231212121333322221112122322131332132212312
3312322122123211231311131122311213332222212133112123331111232212132211311132212313232211212323212112
1321312122212233232122313123122313132312323123212323112133223333212211223132233132322113332133223311
2311222211322331113213322113321333111132132221331212321322123131232221121122212233332211211212132222
2111112122232322332131212212331231121223233232111132231322313331331133233233211213131221133321333212
1113312232221311211212123332123333333211312311331213131323221331132313311221213312221231323221131113
2312312221331313131332313331322233233222133311113331313131112332311121223213131223331213211331221111
1113322231222233322332122123221112312111321332131223222132131132233111112123213223332212211133312313
1221123211313132222122332113232221132232332313212213123331113112133213222133232122121211331323121331
2323233223332312232321131333232212312222223123332312312131131113112232232222231223232232122323223332
2323232233312232211122113223313231131333312132132231123121213122322332312323112222311112122313332111
3233132333312222211131332122213221321313131313323213223331233213321113232321223332323122232322212212
2231312311331333212223232312223233113111221112213131112313233113221231123213212233213132121313222211
3322221223232133222132221123331312211333332223312112332113122112332132123121322222122323323133332111
3113312123331222212233331213133211112313133321133111221332321322222322123333333131122111231123213312
2212122313322211221123213311213131323133323111211312322132213132312132333222213233311322232113313113
1311132331232123131112123212111233331333111312132123323223211313113323321232223211212322312232213331
1313222232122222312312133231212122212121221112223321131212221123323212133333333132122331111131233323
2331213322313122333223112121113123212222232232212111212231121132223112213223311112132312211212121332
2332231332233131323311111133111212212121312332231121312323311211121221231133331222123121123221111333
2311122232333221231121133131231323211313133221211322122211113122221221112313113223211322123123121311
3213312332213332321311133222213132212313122332121111312311333331221322211312133223311321323111213222
M232123322312331323322311313321231323231323332221332323323322133121323131211121232222332131323211132
