M211313333231212313333123311321321113311213331113222133221121221322233122211112133321133221213113331
3113222211111332333111113232211112131311312333112131113231333321322222333223312221121121331232313132
1323233233312331212313113121231332232321122312223131222331213331113111123132311211112331132212313111
3231323323312322222323211122121131321321122322212311121312311312223113332111311322221122222113111211
1312133112211122213133311312212231131131121313113232111121121313133112313321112222133313233331332332
2311331133322313132132323331122113113123322331112122332232313311123321313112221133133231111321232132
1133312213231313313312212221321323123212211132211131333332123212232322122332122232323211332312322323
3213123111132122223132212221321112331132222233321233232112322132331222322311132323122113322233211311
1212212232113313213311213312332212331122331223312123112331131131312312332131313223232311322312322221
2321121222223322331111213223312222231111231133313332221211131323133312111313223221331123233131123333
3213132322232323131113322322313222212211211321222132122212113133231322222122111322222311223333212312
1131133221333333122233122113332331322211211221223312331211112233332232323131231322311213321211231311
3223123213313212133331212131223211123211312121113133113122323311313232323232331123312221223113233223
2221211212221222211132211322133332311213131123323313131133311221332222233213112222133122123233213222
1213131213312313133331313311332332232113222123132132121223321131211133312133112232311323313121332323
3323231322321132121233111133132121131212331233123322213112212112112112111212311113211112232212123321
3232223132133233221232331223211312213231211222132212212212212323112321231233112312132233133233222211
2113311313321332223223312233322113321112112323213331333323131331311213332121313223232323111213121231
2222321311112323223233223222232212123321111333121312111131331321333233321323311331222312232321213221
2322213112213211322313323112223331312331312232332212111112322213331123132313312132323212131331312333
2211112331311132331231121212131311231233332331121112233221211312221333322112311211133311123211231322
2121321112113313311223222213132312332123212132133111111231322322223133231112233332213113223232221121
2221313113111212212223113211321233121333113213213213111211233113321323321232323231132232221122131322
3333123112231223122312332313231211132212311221131213222133321212133112212131311121211221121221312222
3313311222122213222112312222131211311222123331321111331331121121111322321221322323313221233323122213
3212112313323312231323223233333213123123331123213223321331331321111212111223113121233131133333313111
1112332222222321131321311212332322111223312222312312113323331331333312233133321121322133113313111331
1231111223312323222223131312322121131212311323113111121312123123131123233332322321333322222111323232
1321123122133323123222221222211112112332321222311312131323133231333123323311222212322311123113312112
1223313212122233222131223122313123132332212232313211331233231113232121322321332213311211113113213133
1211213132322321213321221111323212223312123231132211122232213233322231322313111211122122313312133311
1311123123131113213321112213322312333112222232113212321313211222312222333133312323222222222121132212
3311112132113332111322123311231121211132232213313122323321332111213112233213113112332211323123132213
2213322331112233231232212212311333221132321122213211121232233333321113133213133212122132311122213211
2213312131121113123322212211321323113312211132231232313122232232112121131223111332212131112222231311
2111111132311322131311232311213333133211213222113313322111111323332111311131312112222232211321332233
1222133333213332331131222122313211113231132313121122311132221331231312313111321232321221233312331313
1313111322132221111123111321312112313212211312233331332112323232221211313231322232122131132223312321
3111221131233321311133313332333233133113122323331121121313311122211121112123312223311123221232332131
3323221122132313311321131131331311232213311223311313312211112123213312122133123332212231311112121322
1111332332223332231132333231322222222333311233112332123322332213222213312213123233131233232123112331
1323112311331122112321122311322322221222121312323122122311313331113133212231233221111312221121313322
2213113123231132123111333211131113313213121121333223212121323131313313232323313222131231322323233133
1231211231323223133113313222331121313332333123122131212231312221313131332233122223332131313331131323
1321131331331112223122213333121231333311322333212332223133231211213213122232232333221313321133133133
2223323312212232312131312132222221231323122322321232211332232333212233211231122132112221231222311213
2211323123223313332211133213123332232122312222213312221131311232131313233213223232112211313213211212
1113113331113123332331332112213331133233213212121333123323211122212233313123122333221323212222323222
1332313113113112311133322331331131113111222212311322132222113131122113311211332223323232111122232123
2213232111133113133312221123122132121221312113132113133221121232311313322321311333123323111312211232
1332333311313332213222211132111123221212131122232122312132213231333213322223222121131121121212121331
1133213221113233213312211122233112111333123332322221223322321223132222112113221133333121232321332122
2311312231322112213122123132133122212332232132111322211211222313132311221112111213333212331231213232
2223223323321323311122132223133222311212112111233321312332123121233131233311112323211121323223121332
3122321233223322132121311113112123322331131322221112233311223132322313213311231333113332222322221123
1221223313322213311122222122233121221131133233222223122311312212111323111123231122233333111232323313
1332213221333133331133211323113332213313233231133232231112131311321131321233212211323222133222321122
2112323323111112231122311222113112331232111232222113221212311321322111123312333222323233321211333221
1122313123112232132321123232323222333211112111213222232312211113232333321221132313231323131331221213
2231312233121111233311331222223132211132311331332212211312333323222233132131332312223313332111132233
2313312112312321133133313323232332232331313221111222233323333121112212331113113313132112223221311332
3212232121321311213213331232311221331213312312132232211232312231331311233331222323122222113311133233
2211312233122323123222333112131121321123232213322313212313311313231322221213212132131131332112332332
2131322233211232211213133312122231123211221223132311223322122313312322233333222323333312132311331111
1312222121322111231223212121221223113123133223332231321311321233221333312213123111322121232223333233
2333322122123131221122312311332133123212333212113121311132131212333112113111213121132332122123232331
3133132211231213121312111221133211222111113332321323121121221321223321323211211211231133113222312131
2232223333223322311223122112321332321133333312211331131322122323213222113213322131112123111212323213
1311212332221313323312132321311321211133313132311313311221313123322221311123332212312321233223212222
1132233323123123331332313121222123132321323223223123231322222211332112112333131222331222111121231322
1113322132312333121113333323333321323332333311122111321331221233222323323133211122232232213323131332
1121123311112122122311111313313332112123211123313211132211211131212223121133322313231122331111233133
1332311111211212123312213312212221222231321321111321322233322323312312222132321313113113213122112233
3231332131122312112313322312313233211323133211313223131221221132221313231222212121111322122132311121
3333332223131332212321122111221331332223311322231131132313211133311331321313132321131121223122212113
2312133312131323122321222122313112313223331213223331312212331312212211311321331131111212123311312222
1121322123112221113112333111233213311123122322323331231211131222222333231312131133322131131132131122
1211213331332111311113231223133332123232231321311321132222332313131311222121231231313313213231211133
3311322123113311112321231233221313113131231332121233213313223332331322133213332332122131111321113332
2213311331112132331231121221233113232312211323233312131333131233131312131313232223223221313223323313
1211132112113232323111322132231123311112111133333123232313221211211231312321212333123122223121131213
2121122211221332313222233331333321213233223121323222123211133331323212312132331211331331311122323112
3312133121322212332231111221122133123231121222223233232321221311123123123121331112113233311211222123
3323221312123312113311211122313112122313321112311213213111311322231213123221121312223131123133231131
3132121333311213123332333212211313133321133313131233132312121312331132312322332211122133132311322332
3212132211333321211223111223113212331333121323331122311331131121311222123222322131213233122213111221
1123211313333233322112232133333231112312313322233131111333312222211233321221311321322121132112332311
3333231233322333121311123312223232213113122121313332231323223233132111311313122213121211111331133112
2123332212231322311311312113311211321311112311221233312111222111333232113121112131121313122321232223
1111331131212113122122122133133113313232322233131321221232223121122123331111322111132331133331313132
2211132213122231221211332313112313113131132221232232332112332323331223111333331311333321332321321312
1332321232232213231113212313131322322321211232233132323133212311222113313313231122131311312323232231
1123132323211311232233332331113133123212333221212323122123123332232313111322112132211232311232322133
2223133133331113311232322321322123133112212123123121323333222311232322312333331211332122132333121331
2212111211112332313122232121312323221113321131231313212231132222123333112332313122112113122113131332
2222131132321212133333112111122233321333111113312321221221233333332211311131211122122223323233333123
2112212131322311133113113123233121322232131213322313312221232111311222213222211232223233131322123233
1211232211133111232122333233313332312321221222122311121222131211322313212212223311213231332121323111
2211313132322212133111321113113332233221131113123312221322132131221233223132112332233131211223223332
331323322212312331123331112221323213223323111112121111311232323113221232233121122333111211321223332G
