9899989889899998999988988999988999999889889888888999999888898998889889988989899889899998989998989889
9898898988898998899998989988989899989889899988989988999889999999899898889989889899989899898899999899
9888999998989989889899999889889998888899999888998889988888889889999889999888989899898898989889999889
9998988998889999989988999888999998989899899998889888999899899989999998989998989898888889899888889999
9989899998999989888998889898999898889889998988988989999899889998888898988899889988889899889889899989
8999889999898899988899889889989988989888889998999888889998889888989889889888999898999888999898989898
8889889999888898988988899999999999989899998889988888888998898889898898889998998888988989998889988989
8899899999889988889898889999898899889999988898999988889989988898989989988998889899999988888999899889
9898899989999999899998989889889989898899988888888989989889988998898898888888888999988998998998889999
999988899899988889988898889989988999988998898998898898998998988889898988989988999988988888M889899898
9888898989899899999989898888999888898889998998999988899888899988998889889898998989899899998898999898
9998989898989999989998988899998998899988999989889988989889899898999889888889999888998889888989999889
8998888998889899889899888988999998989999998989888898989988889898998988998899988889988989998998989899
8889989998998988989989888989898898898898888888989989899988888898898899988889998989888998899898998999
8889888998989898899889889889898898889999988989888988988889898899988888888888998989888999899998988898
9888899989988988989999989999888988998899898988898898998888889898989999898889989988889898889888989989
8999888889988899999999898888988889998999899888998999899989898999998988888899898888888989999899998888
9888898988988989989898998898998889988998998999999899898989999888898989889888898899988989888889998899
8899988999999889999899898988888899899898998999899888898899889889988998899898899998999888999999988989
9889989888889898988899899888999998998999999898999889999988999898989888988888888899898988888898898899
8899889888999989898888889999999998898988889999999999998888899999998898989999988888999988888899998898
9889888999998999889898998898999988898999988999898899889898989989988988888889998998988899998988889899
9988888998988988998888989888899989898898889899988888998889988899889999988898989899988988898998989998
8888899899888999989888988988988899889889988999889998889998998989989998998999989899888889999989889989
9988898889989988898989898889899989888999989888898988889998889888999888889998989899998989899988898888
9988889889888888998998898999999899989989888989999999899889998989998989899999899898989888898988988899
8899899898989989898889999998889999898989899998888998989899988898889988999999898999989899889988988999
9998889988988899989888898989989989988988999988998888998988888899999888889889988899898999998988989889
8999898988889998998989988989898899898899999989989899989988999889898888898888889889899998889898889899
9898989999898888999989888999998899899898998889999898988888989898898999999898999889999998999988998888
9899898999989989989998899888998898889899889989899899988898899988888988998988988899999889898989998889
8898989898988988998989898988899889988898889999998888899998999998989998999899998988998999999888899889
8898899998889988898999899888999999998989889998898989988898898988898989998888989998998888998888899898
9989989899899888888998899899889989898888899899999889888998998989898988889898988989989989998988888999
9988898898999999989899899989889998898888988999988898999988999999999888898999999998998989989988888889
8988988898989999988888988988888989988889898899889889899898989988898989989988899999988888888988998899
8999988989999898899998999998889998898889888988898889988999889999999889989888899899888899989988988899
8889899989898989889989988898899888888988898998898899888988898999888899888999899889889999988989888898
9989898988988888898899899998999888898889989989998889899999999989898898898888989889989999898888988989
9899889889989889988898999989988988888988989998988999899899899898888898889889888888889899898889999999
8898898889998888889899898888898889889999898898888989998899989998889889988898988999999889889988899889
8999988988989889898999988999989888898888998998888988999899899989898989898888898988988999999999889988
8889888988989898899999898999999999998999889899899898989998999899999888988899989989899998989999998988
8998888998889998988889988988988898988998999888999898899999888998889889899888888888898999889988998999
9889889889988888898898998989988999889898898899888988999999888998898998889998889988898899898898899889
9888889899998998989898898899898989998999888888999998998998888998988988989999998998898989888989998889
8988888889888998998989898899899988888889888998988988999898989989889998998999888898888898998988999888
9899989998999899889888889889888998999888989988888989999888898988899888889988899888888899999998898898
9898888899898898989999999999899889988888989898888888888998888889888888989989888898989899988988999899
9999998889898899889888998988898988898988899889999899998999989988989899899998899998989888888898989988
9998899899999898889999888889998999988999988998898998888898989898899889988898889989898988998898988989
8989999988999999888999999989898988898998898998989888989888899889989899889998889898889989998899889899
9898899988889999888998988999889898989999988999999888999988989998889998998899899888988998998888898989
8889999888989988989899989888988998999889989898999899899988998899989899899988899889898899988998889889
8899899988998898989988898888888898989999898989999998988888989888999899999899898889899888998898898898
8989888998988898989889888888988889989899898899998889989988988999899998989899988999899888888989888999
8998998989898888988998989888998899888989899899898988989888889999898999988898989999999988998998989998
8899989889989898998889988998889899899999899988898888899989999899888998889999899989998989888998989988
9888888998999898999998888988889998898999999899889998888988889889998989998988988999999889999898988889
9989888899988999999899989889999988888889989999899998989899998999998899889889888899899888899888988998
8888898988889999898898989898898998999988988889999989899899999889998898899998989999989898899888989888
8888899998999889899889899889888988889989998889999899889898898998888888999988888889898898888998889998
8889989989989888889898998989988899988989999998888999999899899888988889898899889999998898899998889999
8899989999989998898998998898889899889899988988898999898989889899989998988998999999899999889999999888
8988999988889988888998889889999989999898988998989989898899889889999898988999989989988989988988899888
8989999989889898889999899888889998888999899898998899898998989999899999988888998999888898999899989988
8889988898998899889898888989899989899988899899989899889898898998899888988898988988888899889898898889
9898889988988988888989998999999899899989898998998888899888889888998898898898998889998889999999999898
8988898988888998999988899988889888998988999999998898988899988888989998999998989889899889889888899988
8899899988988899899989988988989898889889999989988889888888999988889989889899898989999899889989998888
8999889888988988898899898899898889999999899989898988998988999999999998898888889889898988988898888888
8898898889998999988998999999889898999899898888889999989999898898998998999899988989899888899999888899
9988989898899899998889988989989988889898998989899899889988889898998998889999898888998999889898898898
9898989998989889899989889898998999899899988898989889899989999899899988889988889888988988999889998999
9988998899998998898899898999899989899989989989898998889989889998989888989998989989998998899999889888
8998988989889889999889988898999999998889989988988898988998989888899998898998999889988988999888998989
8889888898899899989898899889899898998888989988899989988888988888988899999989888889898888899889988899
8898988899888988989998898999889898989888889989989998989989898988888988888898888889899989888898899889
9889998989899899889999888898898898988998989889998998888899998899898889998889898889988989998999889999
8988998988889899889999899989998999889898898898988899899898998898989999999899898989889899989989998999
9899889988889998988999898889889888998889889988999999898898899898889998888988888899888889999888988888
9889898998898889888998988888899898899899899999888899889898898999898998888998998888998889988889989999
8989989998899989898999889888889888998988888998888889989888999988989889988899998999898899988999989998
8988999989989899988998989899998999899989888999898999989889988899998888988998898998898899998988889988
8888998999889998898988988998988998999989988998898899889999999998988988899899988989999989898889888989
8889899999889989899899998998889999998898898898988998998989999888988998988889989989898898999888998889
8998898999989898988899988998999899889989989999998988999888999999989999998999999898888889899899989988
8999998998889998989899899999898898989899988998988899999999899999899989999999889898989889999988889998
9988899898989889999989899998898989898898889988898889899999898988898999898989989889899999889889998899
8889988989899998888998889999998988898988989898899988999888899988888999899899989989889889889898889988
899998988G888898998998988889899899888888899888888999889888899989998888998999988898999998989889988899
9989889988988998989888988899999899899999989998898998989889888998888998898898999889988988888899989988
8888899898988999988888899898888888988888998888988999898998988999898889998898989889989989898998899888
8889989888999899898988888999898988989988989989989989989888899999989998889988998999999899988898988898
9889998989999898989888889899989999899999889898988989998889888899988988989988889888899988888899899999
9899989989999888899999898998888888889899999899988989889988898889888989998998998988988989888989898898
8899999889989888989889989889889899998899999998989988898988899889889999899899899888898889888998888898
8899898889898989889989888989999898988898888888899888889898999889898989889889998999988989899899888899
8898899889988889989899899998899888989888998998999998889989889988898989898998999989899998989888999998
8999988899889999989898989889999999898899989899999889988898988888989998899988899898988899888999898999
