11G1111
1999991
1999991
1999991
1999991
1999991
11M1111
