MMW9A9E9E9W9W9E9E9A9E9A9W9W9A9A9W9W9W9W9E9A9E9A9A9W9W9W9A9W9A9E9W9A9W9A9E9A9E9A9W9W9A9W9A9A9W9W9W9W9W9E9W9W9W9W9W9A9W9E9
W9E9W9W9E9A9E9W9E9E9A9A9W9E9E9A9A9E9A9W9A9A9A9A9W9E9E9E9E9W9E9W9E9W9E9W9E9A9A9A9A9E9A9W9E9E9W9E9E9A9W9A9A9A9W9W9A9A9W9W9
E9A9A9E9E9W9A9E9W9W9A9W9A9A9A9W9E9W9A9E9E9A9E9E9A9A9E9E9E9E9A9E9W9W9A9E9E9E9W9A9E9A9W9W9E9W9A9A9W9W9E9E9W9A9E9E9E9E9A9W9
E9W9A9A9W9E9A9E9E9A9E9W9A9W9A9W9W9A9A9W9W9A9A9A9E9E9W9A9E9W9E9A9W9E9A9A9E9A9E9E9W9A9E9W9E9E9A9W9E9E9A9E9W9W9A9W9W9W9A9A9
W9E9E9A9E9E9W9A9W9A9W9E9E9A9A9A9W9E9W9W9W9W9A9W9W9A9A9A9A9W9E9E9W9A9A9E9W9W9E9E9W9A9W9A9W9E9A9A9A9E9A9E9A9A9E9E9E9A9W9W9
E9A9E9A9E9E9W9A9A9W9W9A9E9A9A9W9A9A9E9A9E9W9W9E9W9A9W1E1E1A1W1W1W1E1W1W1A1A1A1W8W9E9W9E9A9E9A9A9W9A9E9E9E9A9E9A9E9W9E9W9
W9A9W9W9W9E9W9W9A9A9E9A9E9E9W9A9E9E9A9E9A9E9W9E9A1W1W1E1E1W1E1A1W1W1A1W1W1E1E1A1W1E9A9W9W9A9A9E9A9W9A9A9A9W9E9W9E9E9E9A9
A9A9A9E9W9E9E9E9W9E9E9W9E9W9E9W9E9W9E9A9W9W9A1A1E1E1W1A1W1W1W1W3W3W3W3W3W1E1W1W1E1E1E9W9A9A9E9E9E9A9W9E9E9E9W9E9E9A9A9E9
W9A9A9A9W9A9E9A9A9W9A9W9E9E9E9E9E9A9E9W9W9E1A1W1A1W1W3W3W3W3W3W3W3W3W3W3W3W3W3A1E1E1W1A9A9E9A9A9W9E9W9A9W9E9E9E9A9A9E9A9
A9A9E9A9W9W9W9E9E9A9A9W9E9W9A9W9E9E9W9A9A9A1A1A1W3W3W3W3W3W3W3W3W3W3W3W3W3W3W3W3W1A1W1E1W9W9W9E9W9A9E9E9E9W9W9E9E9E9E9A9
W9E9W9E9A9A9A9A9E9A9A9E9A9E9W9A9A9A9A9E9A1W1A1W1W3W3W3W3W3W3W3W3W3W3W3W3W3W3W3W3W3W1E1A1W1E9E9A9A9A9E9W9W9E9A9W9E9E9W9E9
E9E9E9W9W9E9E9W9A9A9W9W9W9A9A9W9A9W9W9A9A1A1A1W3W3W3W3W3W3W3W3W3W3W3W3W3W3W3W3W3W3W3W1E1A1A9E9A9A9E9A9E9W9A9A9E9W9E9E9A9
W9A9E9A9E9E9W9W9E9E9A9W9A9W9A9W9W9E9W9A8W1E1W2W3W3W3W3W3W3W3W3W3W3W3W3W3W3W3W3W3W3W3W3W1W1E1A9W9E9A9W9E9A9E9W9W9E9A9A9W9
W9A9E9E9W9A9W9W9W9E9E9A9A9E9W9W9W9W9A9E1A1A1W2W3W3W3W3W3W3W3W3W3W3E1W1A1W1A1E1A1A1W1E1W1W1W1E1E9E9A9W9W9W9A9W9W9A9A9E9W9
W9E9A9E9A9A9A9W9A9E9W9A9W9A9A9A9W9W9W9W1W1W1W2W3W3W3W3W3W3W3W1A1E1W1W1W1W1E1W6W6W6W6W1A1W1W1E1W1E9E9A9E9A9W9W9W9A9W9A9A9
W9E9W9W9W9E9A9E9A9E9E9W9A9A9A9W9W9W9E9A1E1W2W2W3W3W3W3W3W3W1E1W1W6W6W7W7W7W7W7W7W6W7W7W7W7W6E1A1A1A9E9E9E9W9A9W9W9A9A9A9
E9A9A9A9E9E9A9E9W9A9A9W9E9E9W9E9A9E9W1A1W1W2W2W3W3W3W3W3W3A1W1W7W7W7W7W7W7W9E9A9A9E9A9W9W6W7W7E1E1W9A9E9W9E9E9E9A9E9E9E9
W9E9W9E9W9W9E9W9A9A9W9A9A9W9A9E9A9E9A1A1W1W2W2W3W3W3W3W3A1E1W7W7W7W7W7W7W6A9W9E9E9A9E9E9W9W8W7W6A1W1A9E9E9A9A9W9W9A9E9A9
W9W9W9A9E9E9E9W9E9W9E9A9E9W9A9A9W9E9E1A1W1W2W2W3W3W3W3W3E1W1W4W7W7W7W7W7W7W8W9E9W9A9A9W9A9W9W7W7E1A1W9A9A9A9E9A9W9W9W9A9
A9W9E9W9A9W9E9A9E9E9E9W9E9W9A9A9E9W9E1E1W1W2W2W3W3W3W3W3E1W1W3W6W7W7W7W7W7W7W7W7W7W7W6E9E9W6W7W7W4E1E1W9A9W9E9W9E9A9E9E9
E9E9E9W9A9E9E9W9W9A9E9A9A9E1W1E1W1W1E1W1E1W2W2W3W3W3W3W3E1W1W3W3W4W7W7W7W7W7W7W7W7W7W7W7W7W7W6W3W3W1W1W9W9E9E9E9A9E9A9W9
W9E9E9W9A9A9W9W9E9A9E9A1A1E1A1E1E1E1A1E1W2W2W2W3W3W3W3W3E1W1W3W3W3W3W6W7W7W7W7W7W7W7W7W7W3W3W3W3W3E1E1W9W9E9W9W9A9W9E9W9
W9E9W9A9W9A9A9E9E9A9A9W1E1E1W3W3W3W3W1A1W2W2W2W3W3W3W3W3A1A1W3W3W3W3W3W3W3W3W3W3W3W3W3W3W3W3W3W3A1W1E1W9W9W9A9W9E9E9E9A9
W9E9W9E9A9W9E9A9E9E9A9E1E1W3W3W3W3W3W1E1W2W2W2W3W3W3W3W3W1A1W1W3W3W3W3W3W3W3W3W3W3W3W3W3W3W3W3W4W1A1W1A9E9E9A9W9A9E9W9E9
W9E9W9W9W9W9E9E9A9W9W9E1A1W3W3W3W3W3E1E1W2W2W2W3W3W3W3W3E1W1A1W1W3W3W3W3W3W3W3W3W3W3W3W3W3W3W3E1W1A1W9E9A9W9E9A9A9W9W9A9
E9A9A9A9A9E9W9A9A9A9A4A1A1W3W3W2W2W2W1W1W2W2W2W3W3W3W3W3W3A1A1A1W1W3W3W3W3W3W3W3W3W3W3W3W4E1W1A1A1A1A9A9A9E9E9A9E9A9E9E9
A9E9A9W9W9A9A9E9W9E9A1A1A1W2W2W2W2W2E1A1W2W2W2W3W3W3W3W3W3W3W1W1W1E1E1W3W3W3W3W3W3W3A1A1W1A1E1W1A1E9A9A9W9E9W9E9E9A9W9E9
A9A9A9E9A9W9W9E9A9A9E1A1A1W2W2W2W2W2A1W1W2W2W2W3W3W3W3W3W3W3W3W1W1W1A1E1W1W1E1E1W1A1A1W1W1W1W1W1A1E9A9E9A9A9A9A9W9A9W9W9
W9W9A9A9W9E9E9E9W9W9A1A1A1W2W2W2W2W1E1A1W2W2W2W3W3W3W3W3W3W3W3W3W3E1W1A1A1E1A1A1A1W1W1W3W3W3A1W1E1A9W9E9W9E9E9W9A9E9E9W9
A9W9A9A9A9E9A9A9E9E9A1W1W1W2W2W2W2W2E1A1W2W2W2W3W3W3W3W3W3W3W3W3W3W3W3W3W3W3W3W3W3W3W3W3W3W3W1A1A1W9A9A9E9E9A9A9W9W9W9A9
E9W9A9A9A9E9A9W9W9E9E1E1E1W2W2W2W2W2E1W1W2W2W2W2W3W3W3W3W3W3W3W3W3W3W3W3W3W3W3W3W3W3W3W3W3W3W2A1A1A9A9W9E9A9W9A9E9A9E9W9
W9A9A9E9W9W9W9W9W9A9E1E1W2W2W2W2W2W2A1E1W2W2W2W2W3W3W3W3W3W3W3W3W3W3W3W3W3W3W3W3W3W3W3W3W3W3W2E1E1E9E9W9W9W9E9W9A9A9E9E9
A9W9W9W9W9E9W9A9A9A9E1E1W2W2W2W2W2W1E1W1W2W2W2W2W3W3W3W3W3W3W3W3W3W3W3W3W3W3W3W3W3W3W3W3W3W2W2E1E1E9A9W9E9W9A9E9W9A9W9W9
A9E9W9W9A9A9A9A9A9A9W1E1W1W2W2W2W2W1W1E1W2W2W2W2W3W3W3W3W3W3W3W3W3W3W3W3W3W3W3W3W3W3W3W3W3W2W2E1W1W9A9E9W9E9A9W9W9E9A9E9
E9A9E9E9W9W9E9W9A9A9W1W1W1W2W2W2W2W1E1W1W2W2W2W2W2W3W3W3W3W3W3W3W3W3W3W3W3W3W3W3W3W3W3W3W3W2W2W1A1E9W9W9A9W9E9E9W9W9E9A9
A9A9W9W9A9E9A9A9E9E9E1W1W1W2W2W2W2W1A1E1W2W2W2W2W2W3W3W3W3W3W3W3W3W3W3W3W3W3W3W3W3W3W3W3W3W2W2E1W1E9A9A9E9A9E9W9W9A9W9A9
E9A9A9E9E9W9E9W9A9W9W1A1W1W2W2W2W2W2W1W1W2W2W2W2W2W3W3W3W3W3W3W3W3W3W3W3W3W3W3W3W3W3W3W3W2W2W1A1A1E9E9W9A9A9E9W9W9A9E9E9
W9W9W9E9A9W9A9E9E9W9A1E1W1W2W2W2W2W1W1E1W2W2W2W2W2W2W3W3W3W3W3W3W3W3W3W3W3W3W3W3W3W3W3W3W2W2W1E1W1W9W9W9E9W9A9A9W9E9A9A9
E9E9E9A9W9W9W9W9E9E9W1W1A1W2W2W2W2W2E1W1W2W2W2W2W2W2W2W3W3W3W3W3W3W3W3W3W3W3W3W3W3W3W3W2W2W2E1W1A1W9W9A9A9A9W9A9W9E9E9W9
W9W9E9A9W9A9A9A9A9A9A1W1W1W2W2W2W2W2W1A1W2W2W2W2W2W2W2W2W3W3W3W3W3W3W3W3W3W3W3W3W3W3W2W2W2W2W1E1E1A9E9A9A9A9A9A9A9E9A9W9
E9A9A9W9A9A9W9E9W9A9W1A1W1W2W2W2W2W2W1E1W2W2W2W2W2W2W2W2W2W2W2W2W3W3W3W3W3W3W3W3W2W2W2W2W2W2A1A1W1W9A9E9E9A9W9W9E9W9E9A9
A9A9W9A9A9W9W9E9A9E9E9W1E1W2W2W2W2W2E1W1W2W2W2W2W2W2W2W2W2W2W2W2W2W2W2W2W2W2W2W2W2W2W2W2W2W2W1A1A1W9A9W9A9E9E9A9W9W9A9A9
E9E9A9E9E9A9E9A9A9W9A9A1E1W1W2W2W2W2A1A1W2W2W2W2W2W2W2W2W2W2W2W2W2W2W2W2W2W2W2W2W2W2W2W2W2W2W1E1W9W9E9W9E9W9E9E9E9E9W9W9
W9A9W9W9A9E9W9A9A9W9A9A1W1E1W1W2W2W2E1E1W2W2W2W2W2W2W2W2W2W2W2W2W2W2W2W2W2W2W2W2W2W2W2W2W2W1E1A1W9W9W9E9A9E9W9E9W9E9E9A9
A9W9E9A9W9A9E9A9E9W9A9E9W1A1A1E1A1E1W1A1W1W2W2W2W2W2W2W2W2W2W2W2W2W2W2W2W2W2W2W2W2W2W2W2W2E1E1E1E9E9A9E9W9A9A9E9W9A9W9A9
A9E9A9E9E9A9A9A9W9A9W9W9E9W1W1E1A1A1E1W1A1W2W2W2W2W2W2W2W2W2W1A1W1E1E1E1W1A1E1W1W1W2W2W2W2W1E1W2E9E9E9E9W9W9A9A9A9A9A9W9
W9A9W9W9A9E9A9W9W9A9E9W9E9A9W1W1A1E1A1W1W1W2W2W2W2W2W2W2W2W1E1E1E1E1E1A1A1A1W1W2W2W2W2W2W2W1A1A9W9W9W9E9W9W9A9E9E9W9A9W9
E9A9W9A9E9E9W9A9E9W9W9E9W9W9W9W9A9A9E1W1W1W2W2W2W2W2W2W2W2A1E1E1W9W9A9A1E1E1W2W2W2W2W2W2W2A1E1W9A9E9A9W9W9A9E9A9A9A9W9E9
A9E9E9E9A9A9A9W9W9E9W9A9E9W9E9W9A9A9W1A1W1W2W2W2W2W2W2W2W2A1W1E1A9A9E9E1A1A1W2W2W2W2W2W2W2A1A1W9W9E9W9E9W9A9W9E9A9E9E9E9
A9A9E9W9A9W9E9A9W9W9A9W9E9E9W9W9E9E9W1E1A1W2W2W2W2W2W2W2W2W1A1A1W9E9W9E1A1E1W2W2W2W2W2W2W2E1A1A9E9E9E9A9W9E9W9A9E9W9A9W9
A9E9A9W9A9E9W9A9A9E9A9W9E9E9A9A9A9A9E1E1E1W2W2W2W2W2W2W2W2W1E1A1W9W9A9W1W1W1W2W2W2W2W2W2W2W1W1E9W9A9E9W9E9E9W9W9A9W9E9A9
E9W9E9A9E9A9W9E9E9E9A9A9W9E9A9W9A9W9W1W1A1W2W2W2W2W2W2W2W2E1E1A1A9E9W9W1W1W1W2W2W2W2W2W2W2A1W1E9A9E9A9E9E9E9W9E9E9A9W9W9
A9E9W9E9E9W9W9W9E9E9W9W9A9A9A9E9W9A9W1A1A1W2W2W2W2W2W2W2W2W1W1W1E9W9W9W1E1W1W2W2W2W2W2W2E1A1A1E9A9E9A9W9A9W9W9W9E9W9E9E9
E9E9A9E9W9W9E9A9A9A9A9A9E9A9A9E9E9W9A9A1W1W1W2W2W2W2W2W2W2E1A1W1E9E9E9W9A1E1E1W1A1A1A1W1E1E1E9A9W9W9W9A9W9A9E9W9E9A9W9A9
E9E9A9A9W9W9E9A9W9W9W9A9W9W9A9W9A9W9W9E1A1E1W1W2W2W2W2W2W2E1W1W1W9A9A9E9E9A1W1W1E1A1W1W1W1W9W9A9W9E9A9A9E9E9E9W9E9W9E9W9
E9A9E9E9E9E9A9W9W9E9E9A9E9W9A9A9E9A9A9E9E1A1E1E1A1W1A1W1W1E1E1E9W9A9A9E9A9W9A9W1A1E1A1W9A9E9E9A9A9W9E9A9A9E9W9A9A9E9W9E9
A9A9A9E9A9W9E9W9W9A9E9W9E9E9E9A9W9E9E9A9E9E1W1E1E1E1A1W1A1A1E9A9A9W9A9A9E9W9A9W9E9E9W9W9E9E9W9E9W9E9E9W9A9E9W9W9E9W9E9E9
W9W9W9A9A9A9E9W9E9W9A9A9W9A9A9A9W9W9E9W9E9A9E9W9A9E9E9A9E9W9W9A9W9W9E9W9A9E9W9W9E9E9W9A9E9W9W9W9A9A9W9E9E9W9W9E9A9E9E9E9
A9A9E9E9A9A9E9E9A9E9W9E9W9E9W9A9A9E9A9E9A9A9E9A9A9E9A9A9E9W9E9A9A9E9W9A9W9W9W9W9E9W9E9W9A9A9E9A9E9W9E9W9E9W9A9W9W9A9W9A9
E9W9W9A9E9A9A9W9W9A9A9A9A9E9A9A9E9E9W9E9A9A9E9E9W9E9W9A9E9A9E9A9W9W9E9W9A9W9A9W9W9A9E9A9W9E9W9W9W9W9A9A9A9W9W9A9E9W9W9GG
