A6E7E9E2E9E5E3E2W9E6E4E5E8W3E8E9E1E1E4E3E1E4E5E9E2E2E7E2A2E5E6E6W2E9E6E6E1E5E4E2E6E2E8E5E6E7E9W9E6E2E4E3E8E6E3E2E3E9E9E1W3E3A7E1E7E9A1E6E3E2E3E1E6E9E1E6E4E5E1E6E4E1E5E6E4E1E9E4E1A8E8W6W7W2W1E3E5E8E1E9
E1A8E7E4E1E7E7E6E6W6W7E1E2E2A8E5E8E9E1E6E9E6E1E5E4W2E2E3A7E9E9E7E5W4E4E3E2E7E5W6E9E9E8E8E7E3E4E8W5E8E4E7A3E5E2E4W1W3W9E6W7E2E6E6A6E1E9A2E7E8E5E1E3E2E1E3E9E4E3E3E5E4W3W8E1E9E3E2E6E4E8E7E1E2E5E5W5GGE3E3
E9E4E2E9A1E3E9A3E9E9A9E6E7E6A5E4E9E4E8E8E9E1W2E2E7E1E6E7E6E7E8E5E3E1E3E7W1E5W7E9W7E1E8E8W8E8E5E9E5E6W4A8E7A1A7E5E5E5E7A7E2A1A2E9E4W9E4E1E9E7E2E8E6E6E2E2E6W4E4E9E9A1E5E4E3W3E4W6E2E6E8E9E5E2E5E2E9E4A8W3
E8E1E5E6E4E2E4E3E8E4A9E9E4E7E2E2E2E4E6E9A5E6E1E4E8E3E8E8E1E7A3E2E6E9W1E2E1E7W7W1E4W2E8E3A2E5E4E9E3E4A7A5E6E2E3E6E4E4E3E6E2E2E1E9E3E3A1E4E4E8E8E9E8E9E6E7E9E3E1E6E1E7E5E8A7W6E3E3E8E1W4E8E8A5E7A7E5E7E3E2
A4E8E3E3E4E5E3E1E8E2A8E1E9E6E7A8E1E1E9E8E1W5E3E5W4E8E3E4E2E4W9E9E8W1E7E9E2E5E9E4E4E4E4E9E7E8E5E9E9E4A7E7A5W5A2W9E7E3E5E6E5E9E7E8E4W2E9E7W6E7E1E7E6E8E5A4E6E8E8A2E4W2E3E1E8E7A2E9E1E9E1E2E7E3E9E1A7E1E2E7
E4A6E2E6E7E4E5E5E7W5E7E7E7E8E9E7E9E4E6E3E5E4E5E4E2E3E5E3E8E6E5E7W9E8A3E2E6E2E5E4E8E4A1E7E2E1E2E9E3E2E5A2E9A3W2E7E6E6E8W7A7A2W2E9E5E3E7E2E3E2E8E1E5E3E8A2W7E6E7E2W8E5E3E4E4E5E8E1E8E2E3E9E6W2E7E3W7E5E1E6
E8A8E6E4E5E1A3E7E4E4W4E5E7A7W1E5E4A1E1A5E5A4A7E2E2E9E4E1E4E4E3E8E9E4E7A6A8A9E4E2E2E9E9E1E7E9E8A6E5W9E4E1E2E7E2E2E4E8E1E7E7W8E5E1E9E4E5E4E8E3E6E9E1E5E3E6E8E6E8E8E1E4E5E4E2E3E5E9E1E9E3A2E8A2E3E8E1E3E3E1
E7E1W2E4E1E6A8E4E6W7E5W8E9E9E9E3E5E3E5E7W7E6E8E2E9E3E5E7E9A9E5W8E1E5E1E7A6E6E2E7E4E7E5E4W6W3E2E9E9E2E2E9E9E7E7E4E2E5W6E2E5W2E8E4E6E4E6E3E4E4A7A8E4E4E3E3A2E2A8E7E2E7E2E8E5E8E9E2A3E2E9E6W7E2A2E8E9W4E4W8
E6A7A9W8E8E3W1E2E9E8E6W2E5E3E4E2E6E4E5E5E2A4E3E4E8E2E8E6E2E1E9W3E3E1E6E6E7E3E1E4E5A6E1E9E9E6E4E8E3E7E7E1E3E7E6E8E3E4E2A8E3E2E5E7E2E5E1E4E9E7E9E7E2E1W8W1E2E1E8E6W3E9E7A5E1E5E1E1E3E9E1E5E6E3E7E6E7E6E4E9
E3E1A2E5E8E6W2W9E2E3E7E8W2E8E9E6E8A4E8E1E1E7E5E7E7E6W5E3E2E1E1E8E7E3E9E3E3E2E4E7W5E8E9E2E4E6E2E3E7E1E3E7W9W1E6E6E4E4E9A2E2E4E1E4E2A4A8E7W4E3A5E5E6E4E3E4E3E4E3E5E7E7E9E9E8E4E6E8E8E5E5E7E3E1W4E7E7E1E5A1
E2E9E7W6E3E7A6W5W1A9E8E5E6A3E9E3E7E1W5A6E4E5E4E9A1E1E8E3E6E9E5E5A4E4A9W4W3E9E5E1E2E4E5E6E1W6W7E6E7E1E7E6W5E6E7E2E3A6E8W1E6E5E1E1E9E9E8E2E9E1A7E8E7E4A3E9E8E5E9E6E6E1E4E7A1E8W3E4W6E5E8E3E1W2W4E9W9E6A7E1
E8E8E5A1E3E9E7E3A4E6E8W7E8E7E2E2E4W6E2E8E3E2A3E2E9E7E3E5E4E9E3E4E7E6W6E7A1E7E8W8E7E8E1E8E9E8E5E1E3E1E9E3E7E7E3E3E8E6E1E8E4E4E9A6E2E6W5W8E7E8A1E8E1E2E5E9A6E9E1W7E9E1E9E2E3E4E3W8E8E3E9E5E7E8E8E9E4E6E3E9
E5A3A1E8W2E8E7E9W4E9A5E4E2E6E4E5E4A1E9E5W7W4E6E7E1E1E9E2E6E6W9A7E5E4A6A5E9E4A2E9E5E3E6E8E3W6E3A5E7E7A7E2E4E1W3E8E1E2E1E8A2E2E3A6E9E8E5E2W9E8E9E6E7E9E8A6A5E9E6E1W5E4A4E7E6E6E8E6E5E5E2E9E8E2E1E4E3A4E5E6
E7E7E6E7E3E4E4E3E1E2E4E4E4W8E1A6A8A7E7E6E7A2A7E9W2E6W8E8E6E3A4E5E6E5E5W4W8E3W8W3E7E5E1E4W6E8E7E1E8E1E5E6E4E8E1E1E2E2A1E1A3E9E5E8W8E5E3E3E9E9A9E2E6W9E7E7E7E6E8E9E7E7E4E4E8E8E3E1E6A1E6E2E2E7E7E7E6E4E1E2
E1W2E8E7E5E4E5E4E4E3W3A1E2E6E8E8W6W7E1E8E6E4E8E5E9E5E7A1E7A9E9E8E4E5E2W7A2W2E4E2E2W9E4E5E3E9E1A1E9E1E9E9E1E9E3E9E1A5E8E7W5A4E2E8E3E8E1E9E2W7E4W2E9E7E4E8E4E3A3E6E7E4E3A3E7E7E7E4E9E6E3E6W7E8A3W7E4E4E5E9
A4E7E1E4E4E8E6A6E5W8E5E6E9E7E9E8E2E6E5E3E4E5W5E1E7E1E1E6E1E8E3E3A7E8W1E3E9E9E4E2E4E7E5E4E4W2E3E6E3E5E7E7E1E2W9E9E2E3E6W4E6E5E2E6E7E2E1E7E8E8E7E4E2E4E1E6E9A6E5E7E6E4E1E9E6E7E9E9E4E5E9E3E3E7E2E9E8E4E2E7
E9E6E9A4E2E2E5E8E4E8E2E8E7E2E5E2E5E7A7E3E5E7E3E2A6E9E1E4E7E9E2E3E9E5E5E3E2E9E7A6E5E1A4E4E2W5E9E6E7E8E5E8A1E5E4E5E5E4W4W2E8E4E3E1E8E3E3W9E5W7E7E4E3E6A6E6E3E1A9E1E5A9A7A5E6E4E6E1A7A7E1E1E8E5E2E1W9E9E5E1
A3A4A6E8E8W9E2W6E2E2E3E7E5E4E8E5E7E5E8E3W7E5A9E6E5E9E3E5E5E9E7E6E2E2E1E3W7W3E3E3E7E5E3E9W1E1E4E6W6E8E9E6E2E3E6E6E7W5E7A5E6E1E9E2A7E1W1E8E1E8E7E2E7E4E6E2W5E4E7E4E1E5E3E8E1E1E1E8E6E9E3E4W6E9W3E4E4E3W9E9
E4E5E3E5E3W5E5E8E2E5A5E8E8E5W6E1A3E8A6E4W1E2E5W9W1E3E7E7E5E2E3A2E4E7E1E9E2E5E2E8E1E5E7E3W4A4E3W5E1W4E4A4E4E5E1E2E4E8A2E6E2W6E7E8E6E1E7E7E5A8W7E7E8E5W6E2A4A2E8E6E4W7E5E7A2E4E9E2A9E2E4E5E8E2E8E9E9E9W5E5
A5E2E9E2E3E7E7E4E7E5W9E8W1E6E7E3E4E7E6E7E6E4W2E1E3E4E3E4W2E6E2E1E6E5E6A1E7E6E5E1E3E7E4E9E9E1E2E8E8E5E8E9E7E3E1W6E7E2E2E2E9E1E7E4E1E7E9A9E2A2E5E8A5E9E1E4E4E4E7E7E7A2E2E4E1E1W4E8E1E6E5E3W1E6E5E6E6E8E2E3
E2E8W8E5E1E5E5E6E4E8W2E7W2E7E2E2A2A6E6E6E6E4E1E1W5E6E4E9E8E8A2E2A2E2E6E1E3E9E9E6E1E6E1A4E9E5E4E8E1E6E3E3E8A3W2A1E4E6E9A1W2E9E1E6E2E6E4E2E6E9E6E9E3W3E9E8E6E5E6A6A5E2E6E9E2E1E3W8E5E5E1E3E8W9E3E5E6W8E2E4
E2E2E6E8E6E5E4E3W6W5E4E8E8E1E6E5E7E8W9E9E6E8W9E3E1E8E8E8A8E6E3E3E3E9W1E4E3W9E5E6E6E3E4E4E5E4E4E2E7A8E1E2E6E9W4E2E8E2E2E5E7E2E5E7E3E2A1W9E4E9E5E9W8E9E1A6E6E5E5E5A6E1A4E9A1E7E2E3E1E7W5E7E7E7E6A1E9E7E9E9
A7E3E2E3E3A5E3E7E8W2E4W1E9E8E8E8E8E2E4A7E8E8E5E5E7E1A1E5E7E4E4E2E4W2W4E6E8E1A9W4E1E5E1E8E3E3E6A5E5E8E4E4W2E7E6E5W9E5E8A2E7E5E6E2E7A5E2W4E9E2E4E7W2W8E1E8A4A4A5A9E4E4E7E9E6A5E4E3E6A2E9E2E4E9E2E4E6E4E1E8
E2E5W9E3E9E6E5E2E3E5A4A9E8W9E8A1E8E3E7E6E5W1E6E1A9E2E7E4E5E5E3E7W5E9E1E5E6E7E7E9E5E5E7E6W3E5E9E5W9E1W7E5E8E1E1W1A4E3E3E9E9E9E4E6E2E2E4E4E3E7E4E5E6E8E6E8E7E8E7E7A8E6E4W1W5E2E3E7E8E1W7E6E4E3E9E6A9E2E5E1
E1E3W6E8E4E9E6E2E1W7E4E9E8A8E8E5E5E7E6E9E2A4E6E9A3A6E6E8E2E4E5E8E2E8E1E2E3E3E9E8E6E8E6E2W6E3E5E8E5E6A5E8E5E7E7E7E3E6E5E9E2E4E1E9E4W5E8W6W5A7E8E7E5E9W3E5E4E2A9E3E7E5E2A5E7W3E6E4E1E5E7E6E7E8E9E6A5E4E5E7
A3A7E7E9E1E1E1E5E1E2E3A2E5E1E2E1E3E3E9E9A9E7E7E8E1E3W8E5E8E4E3E3E7W1E1E9E6E5E6E6W2E5E2E9E2E6E4E6E6E4W8E8E2W4E3A3E9E1E9E7E7A2E4E6E5E5A2W6E9A2E6A6E4A6E5E7E8E1E9E4A4W9E4A2E4E7E6E7E9E4E6E8E4E3E9E9E4W2E5E1
E4E2E9E3E4E7E6E1E8W9E3E4E8E7E8E8E9E1E9W5E1E4E3E7E3E1E6E3W7E8E1E5E7E6E9E5E6E7E4E4E6A9E1A2E4A3E6E9W8E7E2E1A9A4E8E4E7E9E6E2W2E6E7E3E5E9E7A8W2E4E4E1E6E4E2W3E5E4W7W9A7E3E2W4E7E4E3E3E7A5E9E4W6E1E2E4E1W8E8E8
W8E5E5E3E1E2W8W7E5E7E2E3E8E6E3W6E9W5A8E3E4E8E5W7E5E1E8E3E5W6E6E3E5E1E8E2E3E2E3E4A5E3E8E3E5E8E3E5E1E5E7E2E7E3E6E9E1E9A8E7W4W4E7W6E6E6E7A9E2E8E2E2E7E8E8A3E6E6E3E4E6E8E2E2E8E7E7E6E1E7E3E8E3E1W2E3E3E9E9E4
E3E5E1W2E1E6A8A7E9E3E7E8A8W9E2E9E1E6E4E7E5E1E2E4W4E6A4E6E3W5E8E1E5E5E9E7E8E1E2E9E2E2E1E3E5E3E7E1E1E3W9E4E4E9E6A1E3E4W8E7A2E7E3E5E6E9E2E3E7A7E3E4A1E3E4E4E5A8E9A4E4E8E5E5E3A2E5E8E7E9A8E9E1E3E9E1E6E8E9W8
E2E4E5E5E8E7E2E8E4E2E4E9E8E3E8E2A3E3E2E9E4E9E6W4E8E4E1E7E3E5E5W7E6A4E5E3E8E9E7E3E9E7E1E8E5W5W8E9W6E2E7E9E6E1E3E3E5E5E5E4E1E8E7E6E4E8E9E4E9A6E5E9E9E3E4W7E3E3E7E2E9W4E1E8E1E6E1W6E2E5E6A2E9W9E4E6E2A2A9E9
E8E1E9E5E2E7E9E9E2E9E2E5E7E2E6E2E8E8E8E6E9E9E9A7W8E9E7E4W1E9W1A6E6E4E6E2W1E8W7E4E4E3E6A2E4E1W1E1E4A4W4E4W3E1E8E9E8E2E9A8A6E4E7E4E6E4E2E2E4A6A1E5E4E5A3E8E4W7E1E8E5W7E4E2W2E6E6E3E3E4W3A3W5E8E4E4E6E3E7E8
E2A3E2E1E4E8E9E3E9E7W1E2E7E1E4E4E9E9E7E8E5E7E9E4E3E1E8E8E2W5E5E8E3E5E5E7E3A6E4E1E2E2E2A2E1W9E1E2E2W7E8A7E6E9E5E6E8E8E3A6E9E3E7E8A2E7E6E6E6W9E6E4E5E9E5E7E3E1A7E7E6E8E4E3E5E3E2E7A4E6E8E8E4E3E4E2E5E1E9E2
A8A2E8E1E5E4E3E7E4E8E9E3E8A9W8E9E9A9E3E8E3E2W7E9E3E7E6E8W2E8E2E3E4E6E5E8E8E1W3E9W3E4E8E9E2E8W5E7E8E1E4W2E4E4E3E4E2E2E9E1E1E1W2A8A9W5E3E9E4W4E6E4E6E4A8A9A5W2E5E3E4E9E2E8W7E2E7E7E4E7E3E6E1E5E8E1A5W2E6E1
E7E9A1E1E3E1E3E6E6E4E7E9W4E4E9E2E3A2A4E3E3E9E6E5E7E8E2E2E2E5E7E7E7E3E4W5E9E5W8E2E3E2E6E3E1E2E2E8E6E4E5E5E5E6E7E5E6E1E3W5E8E6E4E4E5E3E7E5E4E3W9A3E7E2E7E5W8E8A4A2E7E5A2W8E7W4A5E3E8W6E8E1E6E4E4A4A1A4E1W7
E4E6E5E7E1E5E5E5E8E9E9A3E5E7A1E5W8W8E4E8E5E8E9E3E5A5E5E1A7E4E9E7E9E7A7E3E6E5W8E3W7E1E4E2E8E5E8W9E6E1A8E9E7E8E7E9W8E5E3E2E5E4W2E2E3E2W9E2E6E6A1E7E1E8E1E8E2E4E1E7E4E8E1A4E6E3E3A4E9E9E9E3E8E6E5W9E8E1E3E6
E7W2E2E5A1E5E7E3E5E4E2E8E9E7E3W5E1E4W9W7E5E8E7E3E3E4E3E9E9E6E6W8E7E5A4A8E9E2E3E1A7E9A9E8E3E3A3E1E8E6W2A4E3E1E1E2E5E8E6W4E6E2E5E1W3E1E1E9E2E5E2E3A6A4E9E9W3W3E2E2E4E1E9E5A6E4E8E9E4E6W1E7E1E6E6E9E5E4E5E4
E1E4E8E8E7A8E3E4E3E5E2W1A3E2A4A8W1E8W3E3A1E2E9E5E7E2E2A6E1E1E9E3A5E4E4W3E8W9E7E1E4W6E9E9W3E7E5E2E9E4W7E2E5E5E7E4E7E7E8E8E6W3E1E9E9E4A4W9E5E2E5E6A1E8A9E3E9W9E2E5E9W8E3E1E6E9E2W7W6E4E3E4W8E4E8E3E6E2E1W1
E7E8E8E8E3E6E8E2E1E5E7W6E4E6E8E9A1E5E1E3E7E2W4E8E8E7E8E6E6E7E5E2E2E3E8E2E2A1A8W6E2E2E1E5E1A9E6E6E5E6E2E7E8E4E9E9E9E8A4E4E4E2E4A3E1E2E1E9E9E8E7E9W5E8E4E1E2E3E1E7E5A2E2E7E5E5E9A4E1E5E4E2E1E2E5W6E1W3E3E3
E3E7E3A6E5E6A5A4E2W8A9A6E4E8E2E2E9E1E1E7E2E3E5E1A4E8W7E4E1A4E4E4W9A9E8E3E9E5E6W4E6E4W4E8E4E7E6E8E7W6E1E9E9E1E6E6A6E8E9W9E1E4E8E9E6E3E4W4E1E9A2E2E8W5E7E4E8E2E2E2E3E7E9E1E7E4W3E1E3E2E9E7E4E1E6E2W8E4E1E9
E3E2E8E7E9E2E3W2E1E6E3E7E7E7E8W6E4E8E1A1E4E8E5E2E8E9E3E5E5E5E4E4E6A9E2E4W7E6E4E3E5A9W3W3E2W8E1E8E9E2E8E5E2E3W3E7E7E8A9E5A7E5E5E9E2E7A4A7E8A6E6E7E4A5E9E2E2E3E7A2E8E3E8E9E4E1E3E6E3E3E3E8E6E1E8E7E9E3W5E3
E3E7E1E6W7E5E6E4E7E9E1E9E6E4E5W9E1E7E6E5E5E3E7W8E4E5E2E6E7E4W7W6E7W2E3W4A3E7E1E5E8E9E4E8E9E6E9E8E6A8E8W9E8E6W9E5E9W2E9A2E5E6E6E2E3E9A6E9E9W4A6E9E5E4E4E3E5E9E8E3E8E3E4E4E1E4E8E9E9E6E5E5E1E2E6E7E8E7E3A5
E8A6E2A7E2E7E7E3A9E8E5E6E2E8E5E8E9E4E2E3E8E1E6E2E2E7E9E2E8E8E9E8A1E4E7W2E4E3E7W3E3W1E7E8E7A6E1E5E4E5E4E4E7E7W2E8E4E3E4W3E3E2E5A5E2W1E5E4E3E8W1A8W5E4E7A3E4E6W2E8E5E8W8W4E8E4E8E9E3E5A2E5W1A2W5W2W8E4W1E3
W3E7E1E1E5E3E3E6E3E8A3E7E2E8E5E2A4E4E8E5E6E3E2E3E9E1E8E4E7E7E9E6E2E3E3E1E7W2E1E4E2E8E2A1E2E3E2E8E6E8E3E3E5E8E2E9E1E9W7E9E8E1E9E1E8E7E1E4E8E2E3E1E1E8A4W9W5E7E1E8A2E8E9E3A6E3E1E8E8E6E9E4E9E4E8A1E7A3E8W1
E6E5E3W4E4E7E8E2E2E3E6E9E4W3E8E2W7E9E1E8E1E9E6E9E4E8E7E5A9E1E6E9E3E8E8E5E4W7E5E4E1E4E4E6E9E4E1E5E5E6A8E6E1A9E2E4E5E8E3E3E5E9E6E8E9E2W7E6E1E5E3E1E8E8E3E7E6E2E6E5E5E8E7E9W8W2E6E2E3E3W1W2E9E1E7E6E2E8W7E7
E9E3A3E7E7E9E2E7E2E2A5E2A4E9E8E1E4E4E9E7E5E2E1E7E6E7E9E9A3E1A6E5W2E1E4E4A6E8E8W9E1E4E7E2W8E9E2E6A3E9E1E5E3E6E2E1E4E9E6E8E3E2E3E1A4E5E8E4E4E7E9E2E4E8E3E9E5E7E5E4E7E1E7E5E5E6E8E7A7E8E4E5E2A8E7E5A3E9E2W6
E4E3A6A8E8E4E5E6E6E8E7E6E8E6A7E5A4A8E7W2E5E9E5E4E9E9E1A8E5E1E9W4E2E4E5E2E2E4E1E7E3E4E8W6E9E3A2E9E9E4W6E7E3E6E4E5E9E2A9E7E9W5E9E8E8E6E6E4E9E7E6E7E4E3E2A6E1E4E3E6E2E3W6E9E9E7E4E9E2A5E7W5E7A1E4W2A2E2E2E8
E1E5E4E1A8E5A6E7E9E6E1E5E5E2E6E4W5W4A2A4E1E1E6E9E7E6A2E3E8E1E9E6E4W7E5E2E6W8W9E4E5W2E2E2E4E8E6E3E9E5E3E3E5E7E5E5E5E3W7E5E3E3A3E3E6E4E9E6E3E4E1E5E6E3E8E5E2E9E5E7E4E5A2E4W3E5E6E6E1E3E4W6A9E8E1E3E4E2E7E6
E6E8W3E7E8E8E9E5A7E4E8E9E5E1E5E2E5E8E2E6E6E4E6E9E1E6E2E3E1E6E4E8A7E4A2E3E8W1E3E8E6E3A1E7E3E4E3E1E9E1E9E6E6E3E9E9E3E9E8E5E8E9E6E1E5E9E3E7E3A8E2E7E9E8W2E1E3E9E2E4W6E9E8E9E7E8E9A1W3E3A8E4A5W1E3A8E3E1E9E6
E4E2E1E3E4A8E4E3E2E5E7E6E2E8A9W7A9E6E3E5W4E1E2W1E2E8E4E3E9E7E1E3E2E7E6E7E6E4E3E7E3E6E3E4E4E4E3E8E3E5E1W8E9E1A3E8E5E1W8E3A3E1A1E5E3E4E7E9E7E9E6E8E4E5E2E7E4E2W3E5E4E1E7W1E2E1E1E6E2E8E2E9W5E3E1A5A4E6E7E7
E8E3E8E1E8E4E6E3E3E1E5E6E3E5E7E4E1A5A4E9A6E2E7W1E6E5E8E7A8W9E2E6E2E5E6E4E9E4E8E4A5W5E3W1W3E9E9E3W6E1E8E1E5E2E1E7E9E4E1E2W4E2A6E8E3E7E8E7A1E2E2E7E4E2E3E5E5E4E2E6A8E5E4E7A5E6E9E8E4E7E3E8E3E9A6E9E8A5E3E7
E6E3E2E1W3E7E4E3E6E4E9E2A8E1E1E9E9E2E6E4E3E5W9E4E3E6W1W2E4E3E5E1E6E4E7E6E8E7E7E3E9W4E5A6E8W8E1E9E2E2E3E2E6E2E8W5E2E7E4E1E7E9E6E4E7E6E8E4W2W6E5E3E8E8E3E3E9E2E5E9E4E8W2E6E3E4E6E3E4E7E9E5E8E2E3E7E5A3W4E4
E7W9W5E6E7E5E1E4E2E4E7E3W9E7E4E6E8E6E3E9E8E5E5E2E4E4E1A4E8E7E1E7E3E4E7E9E2E5E9E6E1E6E5A5E4E6E6E6A9E4E3W7W2E3E2E8E8E7E4E5E1E4E8E5E9E3E4E4E9A3E7W9A7E5E4E4E5E3E6E1E8E7E2E9E5E7E5E8W2E1E4E6E7E7E2E7E8E6W2E1
E8E6E9E3E8E1E1E4E9E7E8W7E9E3E4E3E6W1A5E8E1E3E3W6A4E1E9W2E1E1E5W7E6E1A1W8E2A2E5E2E1E5E1A8E1W4E4W5W8E4E9E4E7E2E2E1E6E7A8A3E7E6E6E7E3W3E4E9E1A1E4E4E1E2W5A7A6E9E2E9E4E3E3W6E1E9E7W9E4E7W5E2A1E6E9A3E2E2E9E5
W7E9E2A5W7E7E2W4W9W3E7E8E8A5E8E4E8E5E2E5E7E6E4E7E3E3E4E3E6E3E8E5W6E9W9E3E2E8E3E2E8E3E3E5E8E5E6A8E4W7W2E9E5E5E6E6E3E2E9E8E4E4E8E9E5E7E8E7E9E5E4W7E3A9E1E4E4E4E4E7E2E4E2E8W8E9E1E4E3E9E7E7W5E1A4A6E4E9E5E3
E3E2E7E6E6E6W6E9E1E7E1E5E7E9E2E7E4E1E1W1E7E7E2E2E8E9E1E1W3E1E2E4E6E6W2E8E8E5W8E5E4E2W3E3E6E1E2E9E6W3A6E1E3E8E2E6E5E7E7E9E4E5E1E1W7E1E4E1W8E5E3E7E2E6E8E3E9A7W7E4E5E4E8E2E6E4W8E9E8E3E2E2E1E3E8E2E3E5E3E2
W8E3E4W1E3E5E2E8E4W6E5E9E6E9E6E4W8E3E7E3E6E5E6E9E3A2E7E4E9A1E5W5E3E5E6E9E6A1E3E1E7E6E9E3E8E5E2W2W3W4E4E6E6E6E1E9E9E9E5E1E2E4E7A9E7A3E9E3E2E3A8A9E5E3E9W6E7E2W7W4A7E5E8E3E9E2E8E6E4E4W2E4E5E3E8E6E1E7A8W7
A7E6A5E1E6E9E9E6E2E8E1E9E7A5E5W3E5E6W6E1E7E4E8E6A3E8E9A6E8E5E5E2E1E3E3E4W1E2E9E4E9W6E6E1E9E9E8E9E3E6E9E4E6E2E2E9E2E8E7E7E2E6E9E4E7E5W2E8E4E1E6E9A4E5E4E8E2E6E9E5E2A4E5E1E2A4E7E5E3E1E2E9E4E7E6E7W7E9E9E1
W7E8E3E1E5E3E2A7E5E5E8E4E5E2E4W2E6E9E1E7E3E4E3E2E4E3E8E7E6E1W3E6E3E5E4E5E6E1E6E2E9E5E7E2E3E5E7E3E8A6E4A9W5W1W1E4E8E3E8E6E6E7E4E9E1W2E4A7A4E9E8W9E9E6W4E9E6E2E6E2E8E2A1E4W3W8E6W2E8E7W8E2A6E9E6E4E2E1E1E3
E6E2E7E6E6E1E6E6E8E4A1E1E7E3E5E7W1A6E1E4E6E3E4E6E5A5E1E4E2A9E1E5E8A8E7E7E9W2E4E4E3E5W4E6E4E3W6E8E4E1E3E6A8E8W7E4E2E6E7W7E6E4E5E8E3E7E3A4E1E2E9E4E2E2E2E4E6E9A2E3W7E7E3E1A6E3E3E3E1E1E2W9E5E4E8A5E2W7E1E5
E4E1E7E5E5W2E5A3E1A5A9E8E9E4E7E9E2E1E9E6E5E1E9E2W9E4E3A4A7E1E9E4E8E9E9A9E3E2E1E9E2E2E5E9E4E3E6E4E9E8E8E5W1E1E5E7E8E4A3E7E4E5E8E8A5E1E4E9E2E4A2E5E9E4E5E1E7E2E8E6E4E7E5E2E6E7E2E8A3E7E7E6W3E6E6E4A5E4E7E8
A1E4E1E8E1E5E6A1E4W8E9E9E4E3E7W7A2E1E7A8E3E8E7E3E8E1E3W4E6E7E9E5E8E8E7W3E3A4E5E9E5E4E9E4E4E2E8E6E7E3E5E8W5W9E1E8E5E7E6E6A2E1E6E2E6A3A8W2E4E8A6E9A1E6E5E3E2E6E6E8E9E2E3E3E3E5E8E6E6W3W8E2E4A3E1W5E2A1E7E2
W6E7E5E7E3E9E9E8E1E5E9E3E7W2W3E7E2W3E3E8E1A4E7E3W1E1E5E6E3E8E3A3A2E5E4E5E2W2E1E1E4E5E8E4E2E3E8E5E5E4E1E2W3E5E4A8E4E5E1W4E8A7E7E9E5E7A7E8E1A6E7E8W5E8W9E5E5W8E2E7E1E1E7E1E9E5E1A3E3E1W5E4E6E1E1E1E5A3E3A6
E9E7E9E2E7E2E1E4E9E3E6E6E6E4E6E7E5E3E3E1E9E7A1E6E9E9E2E2A6E3E7E7E3A3E5E7E9E7A7E1E4E7E5E3E5E3E4E3A5A7A4E4E4E8E7E4E4E2E1E8E7E1E3E6E1E3E8E3E7E3E8E9E3E3E9E3E6E6W2E5E8E6E7A7E5A8E8E5E8E9E8E9E4E7E2E8E6E1A2E3
E3E5W3E4E5E5E1E2E5E9E2E8E7E4E7E7W4E2E8A9E1E7W4A2E1W4E2W1A3E8E6E5W6E6E5E9E1E2E6E6E5E8E2E5E1A2A3E4E2E3E2E2E5E3E9E5E2E2E4E5E5E6A7A2E8A4A8E3E2E3E8E3E4W9A6E1E6E3E1E2E5E1E7W2E1E5E4E2E9W2E1E3W6E2E4A4E4E9E7E4
E1W2E1E5E8E1A2E6W1E2E3E1E7E8E8E2E7W2E2E5E7E8E2E9A8E4E8E3E6E2E4W7E5E4E4E3E4A9E7W7E7E1E8A6W2W3E2W6E3E7E7A3E3E9E4E8W1E2E3E1W1E1A4E1A2E1E4E7E4E9E4W8E4E2W2E7E2E6E8E3E5E7E2E1W3E3E6E9E3E4W4E5E6E1A1E3E4E8E7E7
E7E2E9E7E3E4E9E8E4E6E5E5E9W7E8E5E9E8E2E3E6E2E6E1E2E5E1E3E2E4E1E5E2A7A4E3W8E8E7E5E5E9A2E4E7A5E7E2E3E7E1E8E5E3E4E2E5A2E2E3E7E1E6E5E1E8W8W3A8E1E5E7E1E6W2E6E3E7E7E6E9E2E7A8E7E3E3E9E1A7E1E1E8A7E6E5E6E1E6E7
E4E9E7E4E7E9E2E5E7E6E2E8A6E2A2E2E7E4E6E6E8E6E4E3E6E7W5E7E1E5E1A3E3E2E1E2E9W9E5A7E3E1E4E6E9E5E2E1E6E6E9E4E6E7A9E4E1E7A6E7E4E7E2E5E7E7E1E6W2E1W2E9E9E3E1E9E4E3E4E9E2E1E2E3W1A8E8E8E2E8E5E9E9A8E3W1E9A7E2W8
E7E2W6E8A2E7E8E1E2A3E5E9E6E6E1E5E1W9A8E4E3E2W1E2A9E3E7E6E8E2A5E2E6E8E5E3A9E1E7E8E7E3E1E2E3E2E7A7W5E9E9E4E9E6E7E6E6E4E5E6E6E3E2E2E5E1E8W3E5A3E6W1E2E2W5E6E9A5A8E2E3E6A7A7E1E9W7E9E6E9W4E3A9E6W6E8E3A7E2E3
E4E5E3E9E8E9E4E3E9E2E4E6A3E9A6E9E7E4E8E2W5E2E4E3E3E8E2E9E2E9E2E6E7E7E8W7E7E2E6E6E7W1E1W3E3W2E4W1E7E1E5E8E6E5E9E3A3E1W8E3E2E6W2E3E1E8A2A5E1A2E3E3E8E8A3E5W5E1E1E3E8W3W9E2E5E8W8E6E1E6E5A5W2W9E8E7E7E1E9A9
E1E9E2E5A7E5E9E1E8E6E1E3E6E9E5W3E3E1E5E8A4A4E1E5E2E6E4E9E3E9E1E6E6W8E2A3E2E6E1E9E7E2E1E2E3E3E4E4W5E7E3E7A8E6E3E6E3E6E3E4E7E3E9E8E6E1E3W6W7E5E2W8E4E6W6E5E6E2E3E5E4E2E8E7E3A4E8W5E7E1A6E4E2E3E7A5E1E4W2A9
E4E9E4E1E4E3E6E3A7E3E4W4E5E4E9E5W9E4E4E7E3E5E7A1E1E9E8E1A4E8W3E1E7E8E9E7E1E9E8E3A9E6E1E9A5E5E3W2A8E9W1E8E6E5E2E6E3E3E8E1E7E1A2E2A7E7E1E4A1E2W2E7E7E8E9E7E6E2E2E4E1A4W1E1E5E6W4E9E5E8A7E8E4E7E9E5E2W6E3E5
E3E6E2E9E5E8E2E4E8E6E1E9E6E5E9E6E4E5E4E6E3E8A1E3A5W3E9E3A4E8E2E3E8E9E7E3E4E8A8E5E4E5E5E2E2E1A5E1E4E2E1E5E5E3E1W4E9E3A5E4E5E8E9E6E1E5E1E9E1W5E5A8E2W7E8E1E6E6E6E9A6E5W8W6E2E9E9E2E3E2E1E4E4E6E5W8A5E5E7E8
E3E9E7E7E6E2E9E3E6E5E8E5E7E5E7E1E9W6E3E1E7W4E4A3A5E7E4E5W3E3E7E7E3E7E8E4E3E8E4E2A3E3E7A5E6E9E3E7E9E2E9E3E2E1E3E5E4E2E5E8E2E7W8E3E9E4E2E6A7W3E8E5E3E3E3E3E2A1E3A3E2W2E6E4W8E9E8A2E7E6W4E7E6E1E5E7E6E4E3E7
E6A9E9E2E5W5E5E7E5E3E1E9E7E6E8W1E9E2E9E5E5E5E8E2E6E9E2W9E2E9E4E9E5E4E4E5E7E2A6E2E4E3E9E9E5E8E6E4W8E4E4E1E1E1E5E2E2E9E4E4W8E7E3E9E2E8E2E6E9E7E3E3E5E8E9E7W1E9E3W8E9E2E4E3W9E8E9E1E6E3E9E3E6E4E3E8E3E2E1E7
E2E3E2E3E7E7E8E7E8E5E1E3E1E6E5E4A1E3E8E5E9W7E8A3E4E6A2E1E4E2E7E8E4E5E9E3E1E8E3E6E9E6W1E3W2E3E5E3E8E4E2E3A4E9E8W4E5E2E4W8E1E7E9E9E8E5E7E1E3E2A5E9E5E1E4E2E6W5E3E3E9E9E3E3E6E8E9E9A7E8E9E2E9E5E5E3A7E4E7E6
A1E6E4W5E8E9A1E2E2E4E6E5E3E4A3W5E2E1E8E3A7E3E7E4E6E9E7E9E4A2E2E8W4E9E3E7W3A2E1W2E3E6E5E9E4E3E2W9A1E2E6A4E1W5E8E8W8E8E6A3E5E3A6E3E4W7E3E4E6W1E8E6E2E1E7E2W8E1E9E2E3E2E5E5E5A8E8E1E8A6E9E4E3E7E7E2E9E3E9E2
E9E9W4E9E9E9E1E4E4E3W1E1E1E9A6E9E4E2E7E6A1A7W3E8E1E6E7E8E8E7E6E5E3E1E9E7E5E9A3E5E1E4E9E7E3E9E9E5E9E7E2E7W8E7W5E3E2E6E8E1E8E8E5E7E4E9E9E8E9E8W6A3E1E6E6E1E5E7E9E7E9E7E7E8E9E1E3E4W2E8E1E3E5E3E9W8E4E1E7E4
E8E1E6E5A9W3A3E4E9E3E4E5E4E4W3E1E5E8E1E5E5A3A4E8W1A7E5A8A1E7W7E3E9A6E7E4W7E3E7E2E6W6E9E1E3E6W8E5W4E7E9E5W1E6E1E7E3E9E4W6E7E1E5A6E2E3E3E9A1E7W8E8E9E7E1E7E4E2W7W3E2E8W2E8E9E5E7E6E3E6E9E9E2E1E7E3E4E9E8E4
E6A7E7E7E8E8E3E5E8E7E5E8E6E8E1E1E2E2E3E6E6E5E8A9E5E8E4E3E1E8E9E5E6E2A1E7E2A8E7E2E2E5A2E4E8A5E9E2E5E6E8E3W2E1E1A2E6E2E4E3A8E8E6E7E1E7E2W2W5E7E4E4E6E4W6E6E1E4E9E1W5E6E3E2W5E7E7E9E7E4W9E2E6E3E2E5E6E6E4E2
A1E3A6E7E3E7A1E2E1E6E4A6E8E5E4E1W7E3E2E7A4E9E2E7A6E7E6A7E6E9E8E1E1E1E3E1E4E6E4E3E2E7E9E6E4E5E7E3W8E4E8A1E2A4E8E8E5W2A4W5E2W9E5E8E2E4E7E1E3E6E7E4E7A6E8E7E9E2E7A8E6E7A5W9E6E9E7E2E2W1E4E2W9E5E1W6E2E7A1E6
E9E4E4E7A6E5E9E6E8E7E4E7E6E5E5E8E1E1E2E4E7E1E5E3E9E5W2E2A2E3E1E2E9E2A4E9E6E4E9E5E7E3A6A3E4W6A6E2E9E1E6E2W2E5W9A9E1E7E1E3A9E4E8E7E7E7E4E1E9E3A5A4E2E7E1E8E1A5E4W6E2E5E9A4E3E6A6E7A6E7W4E8E2W2E6E1E9E7E4E3
E6E2E3E2E2E9W3E6E1E5E6E6E8E4E5E7E1E9E2E6A1E8E4E9E4E8E2E4E2E5E9E6E4W7E5W5E4E3E7A5E6E5E3E4E4E1E7E3W1E8E6E6E1E1E8E7E8E1E2E2E1E8E2E8E9A8E5E2E7A1E5E2W1A5E1W8A2E7E7E1A7A7W4A8E2E8A5W2E9E6E5A4W6E8E3E8E6W7E2E7
E6E2E4E6A9E4E1W8E9E5E8E7E6W9E1E6E1E2E1A6E3W3A8E7A5E8E9E5E9E7A7A4E1W5W9E6E6E3A1W8E1E8A5E8E4E4E5E6A7W8E3E5E1E9E2E1E9E7E1E5W2E9E6W2A8E9E4W4A3E2E1E1E2E1E5E2W3E8E5E1E4E9E8E3E2E5E4E4A1E2E2E1E5E4E1E3E7E4E5E7
E4E4E5E3E1E9E4E9E8E7E9E2E3W5E8E2E8E5E1E4W6E1W9E6E9E9A4E1E2E1A7E4E3E4E2E1E6E6A9E7E3W1E9E9A6W7E6E1E3E4E6E7E8E3E6E3E4E6E2A2E6E7E4E3E5E7E1E8E3E5A6E2E7E9E8E9E2E2E7A1E9E7A2E5E5E2E6E5E5E5A6E9E3E2E6A4W4E7E9W8
E1A1E8A6E5E8W3E1E6E5A7A5E1A2E3E2E3E7E8E3E6E8W5E9E5E7A6E7E2E2E1E2E9E6E8E4E7E7E3W2E7E5E6E8E1W3E1A7E8E3E9E6E1E8E3E8E6E2E2E2E6E5E6E6E1E7E4E2E6E7E8E4E8E6E5E8E3E4A7E7A8E9E5E9E1E5E6E7E1E7E1A2E1A9E8E3W4E9A5E8
W1E5E4E4E9E7E6E6E1E3W2A2E7E3W7E6E5E2E1E5E6A9E5E6E4E9E8E9A5E7A5E7A7E8E5E4E1E6E8E8A3E6E8E7E9A7W1E9W7E5E2E7E7E1W5E9E2E5E5E8E2E3E3E1W2E6A9E9E2E8E8W3W6E8E4E3A5E2E9E9E5E5E9E3E9E4E2E6E7E6E4E9E1E3E2E7E5E3E3E8
E3E7E1E6W9E6E2E6A2E2E4E1E9W7E3E4E2E9E6E2E8E8E6A4E5E1E5W6W6E1E4E7A8W5E4E2A5E5E5E5A3E8E5E2E4A6E4A5E3E7E3E3E2W9E6E6E3E1E6A5E2E9E1E1E5E7W9E1E9E9E2W8E5E1E4E9E2E4E3E2E6E7E6E9E4E6E4E5E5E8E1W9W3E4E5E6E3E9W6E2
E2W5E5W4E4E6E2W7E7E1E3A4W1E9E2W2E8A8E6E2A8E6E2W3E8W4E1E9E9E8E6E1E8E7E6E1E9A8E4W9E7E5E1E1E4E9E8E4E6E7E6E4E5A8E2E8E4E6A1E1W6E2E6E9E2E7E4E5E1E5E2E2E8W7E7E8E4E1E3E4E5A4E9E3E6E4E8E1E5E9E5E4E3E7E9E9E9E5E5E9
E9E6W9E3E5E8E2E3E6E8E2E8E3E6E4E4E1E2E7E5E2E2E8E8E1E1A9E1A6E9E9E5E8E7E7E5E1W5E2E2E5E4E2E5E1E8E9E9E3E1A6E3E2E7E4E6W5E7E1E3E8E7E7E4E7E2A8E4E6E8E9E9E1E3W7E3E7E1E1E9A9E6E4E6E1E6E2E6A6E6A9A2E9E9E7E3E4E9W3E5
E5A5E4A7E7E8E9E9E3E1E2E1A9A5E5E1A4E4E2E2E6E4E1E4E8E6E4A4E5E3E6E9E2E2E4E4E2E6W5E6E8E1E7E1A2E3E9E3E1E6E5E5E1E1E8E9W5E1A7E5E4E4E8E1A6E4E4E8E4E2E6E7E8A8E4E5E7E1E9E3E7A3E8E1A2W8E3A2A9E6E2E5W4E2E1A6E4E7E4W2
E5E6E1W8A7A7E2E3E5E2E6E5E9E5E7E1E3E5E8E1E4E8E8A4E3E7E4E3E6W7W1E3E1A4E5A3E6E5A4W3E7E2W4E2W2E7E5E6A1E3E8E8E4E7E8E3E3E3E3E8E6E5E1E4E9E5A9E9E9E2E2E5E8E1E7E9A4E9E7E4E7E6E3E5E8E5E5E4E2E5E1W7E7E2E5E5E1E7E1E6
E5W2E8E9E2E2E4E5E5E3E6E1E6E5E6E5E8E4W8A2E6E1E8E8E8W8E8W1W5E2E7E3E8E3E6E9E1A3E4E5W4E1E5E1E5E2E9E9E8E2E4E4E2E6E9A9E8E9E5E3W6E4E2E9A8E4E5E2E4W6E4W5E2E2W1W8E5E6E2E1W8E3E6E3E2E9E5E6E3E5E2E8E3E5E5E7W1E3E2E4
E6E1E6E3E8W3E3E9E5E1E4E4E3E1E5E2E1E1E8E4E9E6W6E5E9E9E6W1E6E4E8E4A7E5E9E4A9E2E6E2E8E4E3E4W5E2E1E3E2E4E4E4E3E8E8A3W4E3E4E2A9W9W7W3E9E5E8E2A7E3W4E1E5E2E6E9A8E9E9A7E8E5E2E4E7W6E9E5E6E4E9E7E8E6E9A6E2E2E5E6
E6E9E1E6E3E4E4E9E1E8E7E4E4E5E6E9E9E4E4E1E7E4E1A5E7E4E6E7E7E1W3E9E5E1W7E1E8E5E5E6E8E9W3E3E8E4E7E3E1E3E4E2E2E9E7E3E2E5E7E8E1E7E6E4E6E2W4E9E8E9E5E2E9E5E7W2E8E8E3E6E9W6E7W3E7E2E4E3E7E8W4E4A8E7E3E7W8E9E5E7
E3E1E8E9E1E1E7E7W1E6E3E7E8E6E7E6E2E5E8E1E8E1E1E5E2E1E8E3E6E6A2E1E9E5E3E5E3E5E7E9E5E1E6E4E7E1E1W7E3E3E3E7W8E8E1E6E6E3E9E2E9E1E4E3W3E8W3E9E5E9E3E6A8E7A8E5E3A2E2E8E6E6A7W2W3E2E4E7E5E4W7E4E4E1E9E5E5E8W8A7
E4E7E5E4E4E6E4E7E1E2E4E8E4A4E2E2A4E6A4E4E7E3A9W7E4E1E3E8A6E1W2E3E5E6E2E3E2E8A7E9W1E9A7E5E1E2E6E1E9E1E7E6E3E6E4E2E2E4E3E8E8E9E3E7E6E9E9E2A7E4E7E2E2E5W9E3A6A9E1W5A1E3E8E5E6E4E3E1E3E8W1E9E9E7E8A1E3A5W8E8
W5E1E5E7E9E2E3E1E5E2E6A4W1E4E4E2A9E1E3A3E7E6E3E9A7A8E6E5E4E5E9E7E4E8E3E7E8E1E7E9E5A9E9E6E1E7E1A4E9A2E8E1E3E8E1E1A6A8E3A3E7E8E6E4A1E3E6E7A1E2E4E5E2E6E7W6E1E2E6E1E5E2E9E9E1E1E9E6E7E1E1E8A5A3W2E9E3E2E1E8
E1MME2A1E5E1A6E3E6W8E4E3E9A2E1E9E1E9E8E1E7E1E6W4E8E3E5E2E2E7A5E4W1A6E6E5E6W4E7E3E6E6E6E7E6E7A7E6E5W4E7W2E9E1E2E2E8E4E9E8E9E2E3E3A3E7E8E9E8E1E9E8E9E1W1E7E7E8E3W6E6W6E1E3W6E9A4E3E2E5E9E6E2E2E7E2E2E3E4E4
E2E2E7A7E4E8E1E8E8A6W4E2E6E7E7A4E8E8E3E1W8E5A9E9E2E6E6E1E5A1A8E4A1E7E6A1W6E3E1W2E8E7E8E6W3E8E1E7E2E2E5E5E7E1E6E9E3A4E7A9E8E5E2E3E2E9E6E3E8E7E7E1E7E1E6E9E9E6E8E3E8E4E6E8E8E4E9E8E3E5W7E1E1E4E9E9E7E3A6E3
E4E3E8E4E3E2E6E7E2E3E3E9E7E7E6E8E2E1E1E1E8E1E2A6E6E7E7E5E5A2E3E6E5E9E1E6E8A9E6E8E5E3E3E7W8A1E2E6A5A7E9E5E6E2E7E2E1A9E1A8E8A5E9E7E1E6E5E8E4E6E4E2E3E9E2W6E1A8E4A4E7E5E4E7E6E6E8E6E8E8E9E4E7E5E1E3E7E8E1E2
