A9A9A9A9A9W9W9W9A9W9A9A9A9E9A9W9A9A9A9E9A9A9A9A7A7E9E9E9A9W9E9A9W9E9W9E9E9E9W9E9E9E9W9W9E9W9W9E9A9A9W9A9E9E9W9W9A9W9W9W9
A9A9W9A9E9E9E9W9E9W9E9A9W9A9W9W9A9E9A9E9A7A7A7A7A7A7A7A8A9E9E9A9E9W9W9W9A9W9E9E9E9W9A9W9W9E9W9W9W9W9W9W9W9W9E9A9A9A9E9E9
E9E9W9W9W9W9A9W9A9E9W9W9W9A9E9E9W9W9A7A6A6A6A7E1E1A2A7E2A5A9E9W9W9E9E9E9W9E9E9E9W9W9A9W9E9E9E9W9E9E9E9W9W9W9A9A9E9W9A9A9
W9E9A9W9W9E9E9W9E9A9W9A9A9W9A9A9E9A7A6A6A6A6A7A1A7A7A7A7A4A4A9W9W9E9E9E9E9E9W9W9E9E9E9E9W9A9W9E9E9A9A9A9E9E9E9A9A9E9E9W9
W9A9E9E9E9W9A9A9W9W9A9A9E9E9A9W9A7A6A6A6A6A6A7A2A7A2A4A2A7A8A4A9A9W9W9A9W9W9E9A9W9A9A9E9A9A9A9E9E9A9W9A9A9A9W9A9E9A9E9A9
W9A9E9E9A9W9W9W9W9A9A9A9E9E9E9A7A7A6A6A6A6A7A7A3A7A3A3A4A5A8A7A4A6A6A7E9E9A9E9E9E9W9E9A9A9W9E9W9W9E9E9E9A9W9E9A9A9E9A9W9
A9E9A9MMA9W9A9E9W9A9E9W9E9W9E9A7A7A6A6A6A6A7A7A7A3A4A7A7A7A8A8A8A8A8A7A6A9A9W9W9A9A9E9A9E9W9E9W9E9A9W9A9E9A9E9A9A9A9W9E9
A9W9A9A9W9A9W9W9W9W9W9W9W9W9A7A7A6A6A6A6A7A7A7A6A7A7A7A8A8A8A8A8A7A7A7A7W9A9A9A9A9E9A9E9W9W9A9W9W9W9E9W9E9W9E9E9E9A9E9A9
W9E9E9A1W1A2A9A9E9A9E9E9A9A9A7A7A7A7A6A7A7A7A7A7A7A8A8A8A8A7A8A7A7A7A7A9A9A9E9W9W9W9E9W9A9A9E9W9A9E9E9E9E9E9A9W9A9E9E9W9
E9A9E2E1E1A2A2A9E9A9W9E9A9A7A7A7A7A7A7A7A7A7A7A6A8A7A7A6A6A6A5A3A7A7E9W9E9E9A9E9A9W9E9A9A9W9E9E9W9A9A9A9A9E9W9W9E9A9E9A9
A9E9A3A2A2E3A3A2A9A9A9W9A9A7A7A7A7A7A7A7A7A7A8A9A9A9A7A6A6A6A3W1A2A9E9W9E9E9W9A9A9A9E9A9E9E9E9W9A9A9W9A9E9W9A9W9W9W9A9E9
E9W9A9A3A3A3A4A3W9A9E9E9A9A7A7A7A7A7A7A7A7A8A9A5A6A5A5A5A5A5W7W6A5A9E9E9W9W9E9W9A9E9A9W9E9A9E9A9E9A9A9W9A9E9E9E9A9E9A9A9
W9E9W9W9A4A4A4E3A2A9E9E9A8A7A7A7A7A8A7A7A7A6A9A5W5A4A4A5A4A4W4W9A3A3A4A4W9W9A9E9E9W9W9A9W9W9A9E9W9A9A9A9W9A9W9W9E9W9A9W9
A9W9W9W9A8A4E4E4A4A3A9A7A7A8A8A8A8A8A8A7A6A5A5A5W4W8A2A2A2A3A4A3A2A3A3A4A4A9W9W9W9A9W9W9A9A9W9E9A9E9E9E9E3A4A9A9W9W9A9A9
W9E9A9A9A9E6A5A4E4A4A2A2A8A8A8A8A8A8A8A5A3A3A3A3A9W8W5A2A3E2A3A2A2A3A3A4A5A4E9E9W9A9W9A9W9A9A9A9A9W9W9E3A3A4E9W9W9A9W9A9
A9E9A9W9W3A5E6A5A4E3E3A2A2A8A8A8A9A8A8A4A3A3A3A3A4W8W6A2A2A4A3A3A3A3A4A5A6A4W9E9A9A9A9W9W9A9E9W9A9E9A3E3A3A4W9A9W9W9W9A9
A9W9W9E2E2W2W3A6W5A4E3A2A2A2A8A8A9A8A8A8A8A3A3A2A6E2W1A3A3A5A4A4A4A4A5A5A2A8A9A9E9E9E4E3E3E3A3A9E3A3A3E3E4A4W9E9W9A9A9A9
A9A9A2W2E2E2E2A4A7E5E4A2A2A2A3A3A4A9A9A8A8A3A2A2A9A8A9A9A9A9A9A5A5A5A5A3A9A9W9E9E9W9A4A4E3E2E2E2A2A2A3A3A4A4W9W9E9A9E9E9
E9A3A2W1A2A2A2E4A5A6A5E2W2A2A3A5E1A4A9A8A8A3A3A3A3A9A9A9A9A9A9A9A9A9A7A9A2A9A9W9A9A9W9A4A4A3E3E3W9E3E3E3A3A4A3E9E9W9A9E9
A9E2E2E2A3A2A3E3W5E2A2E2A2A2A3A3A2A6A4A9A9A3A3A3A3A3A6A6A8A9A9A8A9A9A5A5A8W9A9E9A9A9A9A3A4E4A4A6E3A3E3A9A3A3A3E4E3A9E9W9
W5W2E3W2E6E4E3A1E2E2E2W2A3A4A5A3A5A4A4A5A5A4A4A4A4A4A4A5A4A4W4E4A6A9A6A2A9E9E9W9A9A9E9E9A4A4A4A9E4E4A8A4E3A4E3E3A3A3E4A9
E6E2W4W4E4W8E2A2A2E2A3A4A5E5A5A5A5A6A5A4A6A5A5A4A4A4A4A4A9A9A9A9A9A5A5W9A9W9W9E9A9A9W9W9A4A4A4A4A4E4A9A4A4A4A4E4E4A4A4A4
A9E4E4E4A5W5W5A4W4W5A5W5W4W5W5W6A5A8A6A6A5A7A6A5A5A5A5A5A4A9A7A7A9A6A6E9A9A9A9A9A9W9E9A3A4E4E4A4A4A4A4E4E4A4A4A4A4A4E9W9
W9A9W4W4W5W7E6W6E6A6W6W6W5W6A6W5A8A8A8A7A6A6A5A6A6A6A6A5A5A5A3A3A5A3W9A9W9A9A9W9W9E9E5A4A4A4A4A4A4E4E4E4A4A4A4E9A9W9A9W9
W9E9W9W9E9E3E4W4A5W5W5W7E6A5W4A8A8A8A8A8A7A6A6A6W9A6A6A6A6A6A6A6A7A6W7W7W9E9W9E9E9A9A4A4A4A4A4A4A4A4E4E4A4A4E9E9W9E9A9E9
E9W9W9A9W9A9E9E9E9E4W5W4W4W5A8A8A8A8A8A8A8A7A7A6A6W6W6W7W7A9A9A8A8A7A6W8W4W9A9W9A9A4A5A5A4A4A4A4A4A4A4A4A4A4A9E9A9A9W9W9
W9E9A9W9E9W9W9A9E9A9E9A9W9A8A8A8A8A8A8A8A8A8A7A7A6A7W7W6W6W8A7W7W7W7W7W6W6A5A4W9A9A9W9E9E9A9E9W9E3A4A4A4A4W9A9W9E9A9E9E9
W9E9A9E9W9E9W9E9E9A9W9A9E9A9W9A7A8A8A8A8A8A8A8A8A6A6W7W6A4A4A4W6W6W7W7W7W6W5A6A4A9E9W9E9E9A9A8A3A3E3A4A4A4W9E9W9E9W9W9W9
W9E9E9E9E9W9A9A9W9W9W9A9E9W9W9E9W9A8A8A8A8A8A8A7A6A6A7E6E4E4A5W7W6W7W7W7W7W6W5W4A6A3A9A4E2A2E2A2A2A3W9A4A4W9A9E2A9E9E9A9
E9A9W9A9W9E9E9A9W9W9E9E9W9A9W9E9W9A9W9A8A8A8A8A7A6A6W6W7E6A6W7W8W6W6W7W7W7W7W5W4A8A6A6A3A2A1A2A2A2A2A2E9A4A2A3A2A4E1E3E9
E9E9W9E9E9A9A9W9E9E9W9A9W9A9A9W9A9W9W9A9A8A7A7A7A7W6W6W6W6W7W7W6W6W6W7W7W7W7W6W4W2A8A7W2A2E1A1A1A2A2A2A3A4E3A4A4A4A4A9W9
E9W9E9W9W9W9W9A9W9W9E9A9E9W9A9E9E9E9W9E9W7A7A7A7W7W6W6W6W6W6W6W6W6W6W7W7W7W7W7W6W4A8A8W3A3A2A2A2A2A2A3A3A2A2A4A6A4A9W9E9
W9W9A9E9A9W9W9E9W9A9W9E9E9A9E9E9W9E9A9W9W8W7W7W6W6W6W6W6W6W6W6W6W6W6W7W7W7W7W8W7W5A9A8W4A4E4E4A4A4A4A3E2W1A3A4A4A5E9W9A9
E9A9A9A9W9A9E9E9E9W9E9W9A9W9W9A9W9E9W9E9W8W8W7W7W7W7W6W6W6W6W6W6W6W7W7W7W7W7W7W8W7W9E9W6A4W5E5E5A4A4A4A4A5A3A6A5A5A5W9W9
A9W9W9W9A9W9A9A9A9A9A9A9E9E9A9E9E9A9W9W9W7W8W7W7W6W7W6W6W6W6W6W6W7W7W7W7W7W7W8W8W7W9E9A9A9E9A9A9A9A8W9E9A9A9A9E9E9E9E9E9
E9W9W9W9E9A9A9A9E9E9A9E9W9W9E9A9A9E9W9W9W8W7W7W7W7W7W6W6W6W7W7W7W7W7W7W7W7W7W8W8W7E9W9E9E9A9E9A9E9E9A9A9A9E9A9E9E9E9E9A9
A9A9W9E9W9W9E9A9A9W9A9E9E9A9W9E9W9A9A9E9W8W7W7W7W6W7W7W7W7W7W7W7W7W7W7W7W8W8W8W8W7A9A9A9W9E9E9A9W9E9W9A9E9W9W9W9A9A9E9W9
E9A9A9A9W9W9A9E9A9A9E9A9W9A9A9W9E9E9A9A9W8W7W7W7W7W7W7W7W7W7W7W7W7W7W7W7W7W8W7W7A9W9W9A9A9E9W9W9E9A9W9A9W9A9E9E9W9E9A9A9
A9E9A9A9W9W9E9A9A9W9W9A9A9A9W9E9W9A9A9E9W8W7W7W7W7W7W7W7W7W7W7W7W7W7W7W7W7W7W7W8E9A9A9W9W9A9W9A9W9A9A9W9W9A9A9E9E9A9W9E9
W9W9W9W9W9E9E9E9W9W9A9A9A9A9E9A9A9A9A9W9W9W6W6W6W7W7W7W7W7W7W7W7W7W7W7W7W7W7W8A9E9A9A9W9E9E9W9E9W9E9A9A9W9A9E9E9A9A9W9W9
E9W9A9W9W9W9A9W9A9E9A9W9E9A9A9W9E9W9W9A9W7W6W6W6W6W7W7W7W7W8W7W7W7W7W7W8W8W7W7E9A9A9W9W9E9E9E9W9W9E9W9A9W9W9E9E9E9W9W9E9
E9E9W9E9E9A9A9A9W9W9W9W9W9A9W9E9A9E9E9A9W6W6W6W6W6W7W7W7W7W8W7W8W8W8W8W8W7W7W7W9A9E9A9E9A9W9E9W9A9E9E9E9W9A9W9E9E9A9A9E9
W9E9E9A9A9E9W9E9A9E9E9W9W9A9W9E9E9E9E9W7W6W6W6W6W6W7W7W7W8W8W8W8W8W8W8W8W7W7W7W9W9E9A9E9W9E9W9E9W9E9A9W9A9E9A9A9E9W9E9A9
W9A9E9E9E9W9A9A9W9A9W9A9E9A9A9A9W9A9W9W6W6W6W6W6W7W7W7W7W8W7W8W8W8W7W7W6W6W7W7W9W9A9W9A9W9W9E9W9W9W9W9W9A9A9E9E9W9E9A9W9
W9A9A9A9W9W9E9E9W9E9W9W9A9A9A9E9A9E9W7W6W6W6W6W6W7W7W7W8W8W9W8W8W7W6W6W6W6W7W7E9W9A9W9E9W9E9W9A9W9W9A9A9A9A9W9E9E9A9A9W9
A9W9A9W9A9A9A9A9E9W9A9A9A9E9A9E9W9W9W6W6W6W6W6W6W7W7W7W8W7W8W8W8W6W6W6W6W6W7W7W9E9E9A9W9E9A9W9E9A9E9A9E9A9E9A9A9E9W9E9A9
A9A9W9W9E9E9W9E9E9A9W9W9E9W9A9E9E9W9W6W6W6W6W6W7W7W7W8W8W7W8W8W7W6W6W6W6W6W7W7E9E9A9A9A9W9W9W9W9E9E9A9E9E9A9W9W9W9A9A9E9
A9W9W9A9W9E9E9W9A9W9E9E9W9A9A9W9A9W6W6W6W6W6W6W7W7W7W8W7A9W8W8W7W6W6W6W6W6W7W7A9A9W9E9W9A9W9W9E9E9W9W9E9A9A9A9W9A9W9A9W9
W9A9W9E9E9A9E9A9A9A9E9E9A9E9A9W9W9W6W6W6W6W6W7W7W7W8W8W7W9W8W7W6W6W6W6W6W6W7W7A9A9A9W9A9E9A9W9W9A9W9A9W9A9A9A9A9W9W9A9E9
A9A9A9W9W9A9W9E9W9A9W9E9A9A9A9W9W7W6W6W6W6W6W7W7W7W8W7E9W9W8W7W6W6W6W6W6W6W7W7W5A9W9E9E9W9A9W9W9W9W9E9A9W9A9A9W9W9E9E9W9
A9W9W9A9E9E9A9A9A9W9W9A9A9E9A9E9W7W6W6W6W6W7W7W7W8W8W7A9W9W8W7W6W6W6W6W6W6W7W8A4A4A3A9A9A9W9E9W9W9E9E9E9W9A9W9W9A9W9A9A9
A9E9E9E9W9A9E9A9A9A9W9A9E9E9E9W7W7W7W7W7W6W7W7W7W7W7W7W9W8W8W6W6W6W6W6W6A7A6A6A5A6A6A4E2W9W9E9E9E9W9W9W9W9A9E9W9A9E9E9E9
W9A9A9W9E9W9A9E9W9E9W9E9A9W9W7W7W8A6W7W8W7W7W7W6W7W7W9E9W8W7W7W6W6W6W8A6A6A5A5A5A5A6A7A7A4E9A9A9E9A9A9W9E9A9E9E9A9A9A9A9
W9E9E9W9W9E9W9W9W9W9A9A9E9W9A6A6A5A6A5A5A4A3A4W7W7W6A9W9A9W9W8W8A7A6A6A6A6A6A5A5A6A6A7A8A7A9A9E9E9E9A9A9A9A9W9A9E9W9A9E9
E9A9E9E9E9E9W9E9W9A9A9A9W9A6A5A5A5A5A5A6A5A3A2A2W4W8E9A9A8A8A7A7A7A7A7A7A7A6A6A6A7A7A8A8A8E9A9W9W9W9W9A9A9A9A9E9A9E9W9E9
W9A9W9E9W9E9E9W9A9E9A9E9A7A6A5A5A5A5A5A6A6A6A4A4A4A5A9W9A8A8A8A8A8A8A8A8A7A7A7A7A8A8A8A9A9A9E9W9A9W9A9E9A9E9E9W9A9E9E9W9
E9A9E9A9E9E9E9W9E9W9E9E9A7A6A6A6A6A6A6A6A7A7A6A6A6A7A9W9W9A6A5A5A6A8A7A7A8A9A9A9A9A9A8A7A9GGA9E9W9W9A9W9W9W9A9A9W9W9E9W9
A9E9A9A9A9E9E9W9E9E9A9A9A8A7A7A7A7A7A7A7A7A8A8A7A8A6W9W9A9W9E9E9A9W9W9W9W9E9A9W9E9E9A9A9W9W9E9W9W9E9E9E9W9E9A9E9E9W9E9A9
W9W9E9W9W9W9W9A9A9A9A9A9E9A8A8A7A7A7A8A8A8A8A9A8A6W9E9A9E9A9E9A9A9W9E9A9W9E9E9A9A9W9E9W9E9W9W9A9E9A9W9W9A9W9A9A9W9A9E9E9
E9A9A9A9W9E9E9E9E9W9A9A9E9A6A7A8A8A9A9A9A9A9A7A7E9W9E9W9W9A9W9A9W9A9W9W9W9W9A9A9W9W9W9E9A9E9W9E9W9W9E9W9A9A9E9E9W9E9E9W9
