M99999999999999999999999999999
999999999999999999999999999999
999999999999999999999999999999
999999999999111111111999999999
999999999991133333331199999999
999999999911333333333119999999
999999999912333333333319999999
999999999912333111177111999999
999999999112333177799977199999
999999999112331477799997199999
999999911113331447777777419999
999999133122331444444444119999
999999133122331144444444199999
999991122122333111444111199999
999991122122333331111131199999
999991122122333333333332199999
999991222122333333333332199999
999991122122233333333332199999
999991122122233333333322199999
999991122122223333333321199999
999991122122222233332221199999
999999122122222222222221999999
999999111122222222222221999999
999999911112222111112221999999
999999999112222199122221999999
999999999112222199122221999999
999999999112222199122211999999
999999999911222199911119999999
999999999991111999999999999999
99999999999999999999999999999G
