M937725474
6955459264
1325734437
7896537794
1119614751
9563181615
7116176353
8324393363
7231434285
962532755G
