223232233113221133221221223133333212232233231123313313312131211131212312131333121232222113221233122G
3123333223111121121133211131111233221232122321212223112323123321321132312123112212313122132131321332
2112222322332123313213323112121131232121222322221112312132112231331233323323221221113122113212332333
1332311313112333223211112122133231231313321333121111312232211211231313213333133222131221311333333333
2122122321233232333231123212323122232121331131131331213121212312113133121331221312113122132213222112
3121331133333231323112131211321322111222222121122322212131332133132213132212123113312323221113121321
3321233333113122312211132331312332231211123223323231231233333213123123122322212123321231322122321331
2323222311331331311311313113222131122322233112322332131311332212313121312232221231333312133232112331
3332212111123131222222313131211333321231322223312322321231123311312131322223311231312311121231113133
1133312321213312321311322221112332112233333211211221132121313122123312313122223132113131223332211131
3322213313113332321121322313122123321322212123231223313111331323312213221333112231323112311321312233
1113131111133121123112122212332313333212123322232332213121112321111321121112111311331212211121333222
2211221233331133311233331112333113233333231113333223113313312121223311122212213331231313131221221112
1323232131113213223131112233131312113133121331211133221121312123132233222323222232333112323221321231
1323331133232133333132232232121312222222332231132223333222223231331323323113331311323313132121332311
3231133311321321122213333313113212111232323121222112222323213221113322133113232321212113323233123122
2333332331333232122312132211122221132233222313121313323231332312131133133131111233212331122233212321
2323212211113221112133212313131232321133321331131321113323211233223123333223333332332222232332131211
3331312333233121113332311223312212233212212222121233332131212323312123131223331132131122223123312113
3333222111332231222131132123321213333213122133313121333113323132322123231312113123133212233222131122
3331111121233311312232113112231331312331122133113222133123233322311133111331323112233212311333133333
2123222211222111123233122311211233323221231333213212111323112221333123121213113233321233112332321122
1122333311211123322211311223333221331132113212133221213233221133132311221131313221133122312113111321
1131222332332121132121322333331213112322313232231311231211113122222233113313133311223133133111112222
2312211113211332211313312213232112313221222333322132133121313212233133311213222221123123332113122221
3323323321113121213222311122132312313213121312332222213333332313312211223123212332112323113222113111
1333323322312332123333131223133122323121222313332333221121213122111121221312323332311213211331113232
2112213123123232212123211322311332332321233221213112121333322221312213222111223113111132212213322112
1223223323211232121132231212212233222122122331312211312111131111233223333333122123312233333231212132
3113232323333213333122111313213132112211132113333113313123221121221123312311321313333132132122321131
2123332232113311121231332221333222233322231231221132123313222231332133222223321323132113122133112111
3313211112132112112113223322331332332112332232333321113211232223332131332222311331232331123312323333
1212221332312323333322212231113312111122322222123121221232333213111331332123133321112332212232221233
3311332131313332212233332222123212231312311233133333321121312331133322222221121123311321132213312231
2323221331222311333322232332113321321323211122113232133133223213232323332122222311113112311333223123
1221331322221213212211221211131313221231322223211331322131323213333122222311111211111333333122223222
3311112321333133323333132132111113232132133132123131131122321222321232123212132223213121232212131121
1333213121232123311113233212311322132312211213211312321132122222332333321223233223111333323233323212
2133321333112131221331323111321333131323233321222211211323133333321111132121123312311113333121212223
3311233232132231213232311231322323111212313132323333131222213223313331311323233313311122222222323121
1321113223311111221213233222323111133333121132111321321213322123232113122321111221231233211122231212
1331111223322122321332323223232212233321212331112233322311223311212112222311212212332113323122131321
3311122231231313312113233133311332332133122221223322233132212223211211123211212332322112313321223322
2312323133231113223112311211331323332312211222323222231231213123213233322312331322311333222222223331
1323321232112121321233323132322131133123222212333212211221133312323211312312333331333331132331313111
3122111111122322221113321131213212323123222313321113333322223332312333332233333233321112211213111331
2332332222132122122211313211331133223113132233122123332111333223133313212113133223121331233123223231
2121231132232311211331212232123331112111222122232312131333333233213213123223121331311323321333231212
3131333112213132332323121223222121121211132223121123131112221232231213323232323332322321233332232231
3323111123232223121233323231321123311332213323232322322313332321123111213112131311121312113232332232
1131333123311322232131313331313331222112312212312122313111121231232311213232333211131221111211133112
3332331313232213322232332312132233332333313232212312213332313231323231213323131322113131323122112131
1122112231232221113333211133231132113331222331331232123311232123121212232121332222121313133132321331
3332121232131331131211112133132112322121322212323222311131132123123311221333133111212122111331312211
3322121312322133122211112121323331313233123321211333212213322233323111111231322311333131321222312232
3312332313312112332133223232132221131321323311312122333311113132332322333331123213131112221223123222
3313232122312312131113213223222221232211333113123112132133112112323221232232322212212322211331113232
1223132123121323313331311113331222312311313123231223332332111223231212322213321213231131231312322233
1211121313222232212213212331322212313111221221322332122321213213131331213332311222122333131223333323
2112321133333322212121313233232111233333213222331322212332113132112112123313113233311323232231322131
1223333133332113223313311213231322312132133122133122113232223221331211112332333311131312113322313122
1333111311222331122333323111223311131122323332321333321112312122133133321113113122131321112321222212
2321131131233121313333122112123211231211322122212313233222233332112322222223332311222231223212123212
2232111223321122133113123132212323313313132111232323133213311122331122312323132323222232321122222132
2331332333311323321121221111122311223213212333212332233122221213121312212222131222313132323122323133
1313211313212332231313311123213113221333121131133312323323211231221122121223233233132221132213121232
3132321222123223223323222223231233333211223112312121212123133332311113321122233313322322222221223321
2233323131213233123223132122222322222133211112213123212131311333123111332332323131212112123223121313
2122221312232322311312311212231213212211111313332213232112231231131322233122123312333212131222232121
1322132123121312233211132232112223232113231313131222121213212212321212231321132333133311131213121121
1133223213122331123133123123123211113313232323111113133332121131211123221311123121223331311121132322
3112323233212332332122311312322213232213323223212113111233321122133212121222211123323232231111112131
2222112313222133121321113113212311323311122232213233133113123232112232331121323211122312112111332213
3333232221112221122321113231321311333122323112232122232211122333131122332122112112313213331133232313
1213223133331312113222233211131221213223312212221333211113223311233311122122123212313132223311121131
3212112213111112312121233321331313133131121333232131312232322323333313312312231321113231321213212213
2333123233231111232222132122223313322112131323122132111111131133322132223122211232223221332133313332
3333112321323322232311322332121231223231212211333113333131112212112223222131112132331331211113122121
3123232113311331322121211322232323322332113311213311133313212213331331112133222233113322122221233321
1332231112221222133122312223212232312222133111222321323333231213322133133323323322112231223232333222
1111121112211211232113223223232232231332112211332132331111112312211221211122133322132232333221223333
2312121311111333112333231212213333112323111332321222121212211211122121222132313213321121223232221232
1321211232212221123232312311122111213233313323332221133231223113312313213131312233231133323212132122
3111132331211333123133333323321132312232323321121221121133211311132321223312233323211113123211231221
2122313313332232213133111331333111131232312313332131223132121111121232111312222123221321313323132331
2311311223132122321322313131233133121331332113222132122211122331122133212133221323232331112222111323
2323311112322131332321232223231313321112121222132323233212223111221121221212132313211111331131321113
1213213222221321311322121131221212231111223133313113312213123112123221232233132221321112211233132322
2233113111212223322212232332233112322212231131233321223321323331232131221311333322222222322332331311
2333213113332331122222231223332213132112211312222213232232331212123122113133321313122233123233122312
3233113323323122223123312112322332213222233312131121231133111133113232111323322331323113332111321312
2331232321123323211313133233233321211331213213111133311311232231331222331311223123313221131222233232
3212212212311122321231131312333212131232233321113313212333312213212321211113113112212213131221331332
1123313213211333112133111113232323133223223113231133123232221132232113312232211211231221111213331132
1232312221323322221132112223312222223213112331321222332123131323212232331133132332223122311133111231
3112313311213122122233231131312332331222122123312121221312132233212113332313333112223212312222113322
1222231112233322123332223122322323212121333311133313331212312323233112322123312132313323231132231223
1323133132112311312332113332223121323111333323332123211223221321332121333223322312123122123212213222
2333131333111132323333223212133132231231311131231311323223322131111232331132212312313223323111233311
M323131322211332211333113132322121232321111322122112322121332321112311113211321123323223331223213232
