9889888998889998989889999888989899988898989999998999999889999998998998988989989998989888998998898888
8998989988989988998889888999988899888888989898998889998888889998998998988999998998999889889899999998
9889998988888998898898999998989999899898888889999898899889998889988988989889989998999999999899989988
9889898889889988898999999989999988888888898999999998989989888889988988899888998989999989998988888888
8899888889889898999988999888888889998889988898898989998999888889988889898998899998899988998899889999
9988988898999989989988998898989899888998989988998899888899888899889889999999998888889989998988889898
8888988998889988999889989889898989888999988899998989898889988898888999899999999898888889989898999998
9998988998988899989989899888888988988989989999999998988899888988888889998988899899888889899989898999
9998988989988989899998998899988888989888988989999888989989989998999998899898998899989989989889899899
988988888998999999999899989999989889989998998999889998889899889888988889988999888888999999M998988989
9889888988898898999998989988889899989888899899989899898988999988989989989888989999889898988998999889
8998988898888898899998889889888888988888899888989889899999888989889999999899998989898899999988988999
9998999998888889889988998898898889999999898889899898888988899898989889999899898899988889988889888888
9898988888899899988989999999989988889889999998898889998998988898999988888888999989899989888998888998
8988998999899988899889998898989999898988889889998998999899989899999999998999889999989889889999898898
8899999888898888888899899999988989899888989889888999899999889998999889998999888888999988988988889888
8999899998998989998898898898888998999999898899989999999998989988989989999898988999888899999899989899
8999999988988999998999998999899989989998898988989989888898888898898899988898998888988989998888999888
8889988889998899989889889888988899888889988888899988898888898988989999898889989999989998999998888898
9999999899888898888988888889999898999989998898989899988898899889998998989889988888889998988899888989
8889998998989988989899989898888998899988989898999899989988999989988998888988988998898999999888898898
9999889989999989899899888889988888889989988989899999989889988988888988889999989889899899988889998898
9898989999899899999898899888989988998989998888888888899888889898998998989999988899989889989898989888
9988998988899998899989988988988998899998889999898898989898988998888889999998999999999889998889889899
8889988898889988899888898999998988999989889998998898998898999889899898899888899999989898988998889889
9889899989988989989898889988988998998898899988988988989988989898999999888889999989888989989898998999
9888888998899898989888889989898889989898999898999888898988899989888998998889888999988899898898898988
8989888989888889898999889888989898999988988889899888998989899899989988989889888988999989889888898888
8998999998999988889989989888988989888998888889989898899998999899989899889888899888989989898899998898
8898989999998989898989898999898999999998899888899899999988898888888899988889989999988899889989898889
8899899988989888889998888998999898899899898999989889999888988898889898989988889998999989998898989998
8998889998989989898889899899889988998998899988888899998999998988988889898989988899899899898998998889
9998989998889998988899889998998999989888998899899888998898888999898999889998899998899898898988899988
9999898998898888889999999898998889999999899999899898989998999998989988988888889889998988999899988998
8888899998998988899999899998999999999898888999899888898998889898998988999989989989999889999888889999
8988989899898888999999899988989998988988888999989988899988898998989888889889898889999989898889988998
8999988989988899899999899998998998998999989898888888989889989889989998998988988989899899898898898988
9999989898989998889989988999898889889998888889888988998989898899999999889988988898998899989989889888
8888998998899999989899999889998988889888898988989989899988988998988988898998999988998989989898899898
9899898988888998898998889898998898998989898988898899899899988989999889889989999899889889998889999998
8899988989899899998889989988899888899999888998988989888989989989889999998989898989989899889998988889
9988988988898988989898998998889998998998888899998888899889888899998888998888899989899888889898888898
9898898888899899999989899989999989989888889989888999999899889899989989888889989988988898988888888988
8989889898999899889988889988888899989889899999898999898988888889888899898889888989998898899989889888
9888998998899998888898988998998899999899898889988898889898888888998899989999889998998899888998888888
8998888888989989988999899898998889889988898989888888888988899889999898888989999998888988898988989888
8889999898999889999899998889889989899998999998989889888999898889888999899989998999989999889998889998
8899899898898998999899889988898898888888888889989999898998888998889998898888988998999989988899989898
9998999889889999988889888999988889998888988898899988998898889889889889889889998889889898888888988888
9898899999898888988998899989889988998898999999889898998998899999988898889988998988989989888999889989
9999898998889998889999898999888989988989999898988988988888898999999899889898999898898899998889999998
8998899889888998988889899888988889989898898989999999999898999899889889999898898889999988899888989988
8989899999989998888899988999988989889899898998899988988889888898988889899999889988988899889898989989
8989998999899888989998899988989988988898998998898989998898898999999988999999988888899889989988989998
9899989998898988889898889989989988999898898989989998898898998998989988898899988989898899888899898999
9889999889989999989898889889998898999989899999989889988899889889898988988898998999989898998889898888
9898999988989889898999898899888898889898999898898898898898889999898998988899898999888889999998999889
8999989898898989898989898988988898999899888989888888899998898989989989988889898898899898998888889988
9898898889888888989999998899889989899989898888899999988899889888898888988898988998899998998999988999
8998988998999899998888888898999899998999988899888899998888889899899989898999888889998988999888998998
9998999898898988898999989998988999989998989999998899989988889888899889889888989989988899999989889899
9889989989988888989998989888888989998989888899889899898989888888988989998988999989989889889898989998
8999998998889988888988998888899899988899999998998988989898899988988988888888998999888899988999988888
9898888989888898899898889899899889889898888989889989888898998999999898998898899989889899998888888888
8988899989898989888989889999899999888998999999899988988898888888889899889898999889989889999998888999
9989999998898899988989899888899888889888898889998988899888888899989999999998988999888888989999999988
9898989988889889989999988999898899889899888898889999989988889889999898989989988999989999988999899998
9988889998998998889888888898888898889888999988889999988999889998989988988998989998988989988989988988
8889989888888888988898898998898899999999988998899898889899988898998999898998999888899889898989889899
8989988999888998989899989988899899898989899988899888889898998988889889998988998999898998899899899899
9988989898888899898999999988989989889999888988888899888989899998989898988989999989998989899999999889
9888999999988888899989999888888999888998999998999888989889988889899999899888988889998999988989999889
9898989889888898889889889999898988889899888999888898998898899888898988889889888899999999998889988898
8988988999889899888988998889888899989988899988989998998898888898998888989898998899898998899888989989
9888898998988899989989888998998889888998988889889988898898989898988988998898998989899898889888998999
8888998999998989888889998998999898888999898998988898988988899889989898999888898899998889898888999998
8999989988989888998899899999988898889889899998898998989998988888888998898888988988989899999998888999
9988989898989888988899899899998899989889889989998889889888999889899988889888898999889989999889889999
8888998989888988899889888898999888889999999888989899889889989998999999989888899999888899999989888888
9888999898989898899999889898899998988988998988998989988899988888889988989989989989898898888898989989
8888988898889889888989988989998889988899999899998899999889888988889998888898998999988898988898899888
8898889999998988989888888888898899889988889899888888899898889889889998889898899888988988889888898888
8888989988988899889999999998998999898899988889898889988988999899988898888998998899899898989988898999
8898889998998989888988889988889999898898888898898889888899999888899998898988998998888899899898998888
9899888888998898899988998898999899899899889889888889988888899898989899998899898989989988899998998988
8998988988999989999889888989898989889889989899989888898988899898899888898989998898999999988888889898
9898989988989889888989989998999899988899899999999989898998889898888989988888988988988898989889998998
8988988898989898989988898989998888989989998999989988888888989989998889899989898889998989999888889998
8889899999898888888998999889888988888988998989888888899888998999988898899888998988889889998888888989
8988888988898998899889889899998899999888988898999899988899888989998989989899988889888988998989899889
988889889G999888898999988889999998889889988888999899999898998888998988998888889989998889989889898899
8898898998988889999889998989999988989889998898898988998889889989988988899998888988889898989988898898
9889988899899888889889999899888988898898988899889998899899988889888899889888989888989988999898988899
8888989889898988998999889998998988988989899998889888998989999998989998998899888998998899988999888898
9898998889989999899889988999898999999989988898989989998899899999989988889899998989988889998898889998
9898899888888898999989989889988989888999889988898889989899999999898898988889898888999899889898899988
9999998899889888998989899989899888899889998889889999999888989998999989998999889988988889888889999889
9988989899898889898999888889898889899888889989989898989899889888989888889888989888898998888899998999
9899988998989889989999988989889989888989998889999989998999889989989988998988888989888899898998898999
9898988888898888898899988888999989989888889888898999898999898898898898888998988989988989998989988899
