M999999999999999999999999986799999999999999999999999999999999999999999
9999999999999999999999966667777599999999999999999999999999999999999999
9999999999999999999998666665117167999999999999999999999999999999999999
9999999999999999999966666661667736399999999999999999999999999999999999
9999999999999999999666666611616273579999999999999999999999999999999999
9999999999999999997666666651612223749999999999999999999999999999999999
9999999999999999996666666662723347777888499999999999999999999999999999
9999999999999999966666666666237776877777779999999999999999999999999999
9999999999999999766666666666677677777777789999999999999999999999999999
9991112999999999766666666666767777898777799999999999999999999999999999
9991112699999999766666666666777666567766999999999999999999999999999999
9961122299999997766666666667996655542199999999999999999999999999999999
9992223329999997776667766799889555543499999999999999999999999999999999
9994333321999987777777667795555555566119999999999999999999999999999999
9999443332199977777776676665444444449533349999999999999999999999999999
9999944333229677777778765555557122323222333999999999999999999339999999
9999995433321777788887553323989112222223334299999999999999993349999999
9999946544332217888887332223578312322233345199999999999999323349999999
9999211655432212888887733222356112433333454699993359999993223349999999
9991211246543111379888773221989899954445554499999332333332233349999999
9921311236543211243388883222888899995545599999999333222222233349999999
9321311237663111232548873222299898999999982999999933332392333332999999
9221321234411112235155883333335769999997546999999964333233316333339999
5221133511111223435144674333333545665536529999999993333933373333333399
4233355111112345546353555443333349998885469999999993333333893333333333
9234446222334455545465536544444447788885299999999993333333433334444439
9445444544554434555576554655555443867833999999999933333333333444446999
9934456566655556555887665545555555433537999999999233344433333443999999
9999993344456755457888776665866666666558699999999444444444333449999999
9999999999444434777788877666666776888876484999994444443344433449999999
9999999999996997777778888776666665366776647549997999999934444499999999
9999999999999999977778888877667654446666665734999999999422443499999999
9999999999999999999777788887667543356666666576699982932223243499999999
9999999999999999999997778876666743457666666647764351211122994491118999
9999999999999999999999978866666557767666666654286641111222249613231299
9999999999999999999999987766666556666666667764387631111112224223445499
9999999999999999999999967776666665666666666776428733111112221223644999
9999999999999999999999986767666666666666666777658844333333321134536999
9999999999999999999999997766666666666666666777758844544444433443655999
9999999999999999999999997666666666666666677776769964444444443999943999
9999999999999999999999997666666666666666667777769999999999999999999999
9999999999999999999999987666666666666666677777779999999999999999999999
9999999999999999999999977777666666666667777777789999999999999999999999
9999999999999999999999987776666666666777777777799999999999999999999999
9999999999999999999999987776666777777777777777999999999999999999999999
9999999999999999999999997666666777777777777777999999999999999999999999
9999999999999999999999996666666777777777777777999999999999999999999999
9999999999999999999999976666666777777777777777999999999999999999999999
9999999999999999999999966666666777778888777776999999999999999999999999
9999999999999999999999666666666777788877777777999999999999999999999999
9999999999999999999999666666667777788877666678999999999999999999999999
9999999999999999999997666666667777888766666679999999999999999999999999
9999999999999999999996666666667777888666666679999999999999999999999999
9999999999999999999996666666677776887666666679999999999999999999999999
9999999999999999999966666666677778887666666679999999999999999999999999
9999999999999999999966666666777777876666666679999999999999999999999999
9999999999999999999666666666777797876666666679999999999999999999999999
9999999999999999999666666667777698866666666665999999999999999999999999
9999999999999999999666666667777698866665566677799999999999999999999999
9999999999999999996666666667777998766665556766553259999999999999999999
9999999999999999996666666667776998666665675555556632999999999999999999
9999999999999999666554467676666988666667555554556675999999999999999999
9999999999999999655555533247766998888666665555566777999999999999999999
9999999999999996555455553321477998777776666666667778999999999999999999
9999999999999976555455565333349998877777777777777888999999999999999999
9999999999999966555555666655569997677888888777888889999999999999999999
9999999999999976666666677766679999999999855555556799999999999999999999
9999999999999987766667777887769999999999999999999999999999999999999999
9999999999999998777777788888799999999999999999999999999999999999999999
999999999999999556678888876999999999999999999999999999999999999999999G
