M999999999999999999999999999999999999999999999799999999999999999999999999999999999999999999999999999
9999999999999999999999999999999999999777999984459999999999999999999999999999999999999999999999999999
9999999999999999999999999999999999974445444644479999999999999999999999999999999999999999999999999999
9999999999999999999999999999999999964474445644599999999999999999999999999999999999999999999999999999
9999999999999999999999999999999864574654444444799999999999999999999999999999999999999999999999999999
9999999999999999999999999999985465577465844444599999999999999999999999999999999999999999999999999999
9999777654444479999999999999944464484445474444489999999999999999999999999999999999999999999999999999
9986945444444444779999999999746646478475447444449999999999999999999999999999999999999999999999999999
9988444444444444444899999999657464544797554444446999999999999999999999999999999999999999999999999999
9645444444444444444446999999975555579999544444444699999999999999999999999999999999999999999999999999
9565444444444444444421799999999999999999754444444499999999999999999999999999999999999999999999999999
7777444444444444447811199999999999999999954444444479999999999999999999999999999999999999999999999999
9574444444444444471144459999999999999999974444444449999999999999999999999999999999999999999999999999
9985444444444444214544444467999999999999974444444446999999999999999999999999999999999999999999999999
9995544444444451111444454444489999999999994444444448999999999999998285444445799999999999999999999999
9997554444454581111447444444479999999999754444446732112499999994844444444444445999999999999999999999
9999755544455111117444444444499999997428444448111111111177599544444444444444444489999999999999999999
9999965555447111175444444447999999411144445411111111111114444444444444444444444448999999999999999999
9999999745657444444444444441999997111164451111111111111112444844444444444444444444899999999999999999
9999779555545544474444448141645322223155111111111111111111644444444444444444444444499999999999999999
9996546557547745444444711111451134753111111111111111111111344444444444444444444444479999999999999999
9997554557546685554437111134476638111111111111111111111111144444444444444444444444446999999999999999
9999655555554447574711411744454444611111111111111111111111154444444444444444444444445999999999999999
9999975555555554457475754444657111111111111111111111111111184444444444444444444444444799999999999999
9999999655555554476654444484611111111111111111111111111111174444444444447444444444444699999999999999
9999999975555554479655444471111111111111111111111111111111164444474447877444444444444699999994866667
9999999965555554479975562111111171111111111111111111111111164444444444444444444478747489999576666666
9999999965555554469962221111111411111111111111111111111111184444444444444444444444444845787666666666
9999999975555555469772111115241111111111111111111111111111164444444444444444444444444444446666666666
9999999975555555453111111111161111111111111111111111111111144444444444444444444444444484448666666666
9999999975555555445311111111122111111111111111111111111111144444444444444444444444444464444666666777
9999999975555555445571111111224221111111111111111111111111544444444444444444444444444454444666677778
9999999975555555545557111122223222211111111111111111111111644444444444444444444444444474444667777778
9999999965555555545555611222227222222211111111111111111111444444444444444444444444444484444677777789
9999999995555555555555522222279822222222111111111111111117444444444444444444444444444444447777777799
9999999997555555555555562222799998222222222211111111111234444444444444444444444444444744447777777999
9999999999555555555555552228999999972222222222222222222244444444444444444444444444444444487777778999
9999999999975555555555522499999999999722222222222222222644444456788877777777788876545444777777779999
9999999999999978777999879999999999999997222222222222226444899999999999999999999999999999999977999999
999999999999999999999999999999999999999999742222222237889999999999999999999999999999999999999999999G
