A8E6E9A2E8W7E6E1A5E3E6W9E7E9E4E9E4E8E2E6E1E5E2E6A4E8W7E5A4E8E7A9E4E3E3E8E9E9E3W4A9E6A1E8E7W3E9E6E6A3E8E8E7E3E1E8E4E3E7A1E1E6E5E8E1E6E7E6A4E2E8E4E1E1E9E8E3E8E6W8E5E4E9E1E6E5E4A6E2E5A5E6W4E8A2E4E4E6E4E4
W9A3E5E8E8E8E3E8E5E9E3W2E5E1W4E4E8E3W8E9A7E5E5E6E7E2E9E5E3E3E2E9A9E6E3E2W5E3E7E4E8W4E7E5E8E9E7W4E4E5E5E7E2E1E9E5E4E9E9E7E5E9W5A4E3E4E3E2E2A9E2E5E8E8E5E5E1E4E5E3E4A5E7E8E3E4W3E2E8W8E9E3E3E5E9E7E3GGE2E3
E2E7E7E5E4E1E5E5E9W5E9E5E5A8E5E3E3A4E9E5E8E3E5E8E3E9E9E3E9E3E3E9E2E4E8W8E4E5E1E7E9E4E1A1E5E9E4W9W4E4E6E9W1E8E7E3E1E1E7E6E2E1E1E5E8A3E5E6E7E5E6E8E9E9E8E5E7A7W8E4E6E2E8E2E7E8E3E5E9W3E1E3E3E3E9E2E9W2E3A8
E9E2E6E7E1E7E3A1W8E8E9E3A6W2E7E8W4W3E5E6E5E7E6E6A8E6E7E1E8E6A1E7A5E1E2A2W1E6E6E6E3E9E1E3E8E6E1E1E2E1E3E1E4W8E3E7E5E3W1E2E3E2E4E4A8E9E2E5E4E7E1E5A8E3E1E9E8W4E4E1E4E4E7A5E7E5E3E6E7A8W1E2E5E2E6E5E7E7E8E2
E3W6E8E1E1E1E4E1A9A9E7E7W1E9E8E7E7E1E3E5A7E6A6E6E1E8E4E5E2W6E2E7E8E2E2A9E9E7E5E5E8E8E1A1E6E8E5E4E4E9E9E5E8E7W3E1E8E4E9E5E9W4E8E1E5E7E3E9E6E4A8E6E2A5W3W1E5E4E5A2E3A5W9W4E4E2E2E1E8A4E3E6W6A3E9E1E1W2A4E9
E1E1A6E3E9E6W6E8E5E1E2W1E9E7E4E5E8E7E9E5E8E4E6W6E5E1E5E5E7A3E4E8A6E8E7E5E7E3E1E4E6E8A5E7E1E3A2W4E8E3E2E2W8E4E4E4E4E7E1E1E4E5E5E9E5E6E7W5W1W7E1E9E3E2E7E4E7E7E6E6E3A1E8E6E8E9E5E4E2E7E3E5E1E8E2E7E5E9A1E3
E7A6E1A9E4E6E5E5A7E5E9E9E4E9A9E8E5A5E6E1W3E9E4E4A3W6E8E9E6E6E5W9W7E7E9E1E5E9E9E9E1E3W9E1E7E1A2E5E3A1W7E5A4E1E1E8E3E2E5E3E4E4E1E2E3E8E4E1E9E1W5E9E4E8E3E5E3E1E2E6E4E4E1E9E6E1E5E5E5E3E2E9W5E2W5A8W2E7W5A1
E7A1E3E5E2E2E1E7E9E2E8E2E8E3E9E3E7E3E7A5E7E5A8W4W6E9E1E9E7E2W7A4E1A7E8E7E9E6E2E1W4W3E6A1E3W8E2E5E7W4E9E6E1E5A1A5E2E8W7E5E9W6E9E7W3E1A3E3E5A6A6E9E7A9E9E3W4W2E8E4A2E6E6E1A1E4E3E4A5E3A2E5A1A8E8E6E9E1E9E3
E1E1E9E6E2W1E4E9A9E9E9E1E9E5E6E5E3E4E5E8E2E8E6E5E6E5E3E3E9E9E8E4E6E3E2E5E1E9E8A5E3E7E9E4E1E4E8E4W3E4E9E7W4E4E6E5E8E9E8A2E4E5E6E7E1E4W5E6E2E2E3W4E8E5E2E9E1A4E2W3E2E3E5A4W4W3E1E1E5E7A2E8E3E7A3E8E1E1E8E5
E8E6E4E2E2E6E6E9E2E4E7A4E3E8E9E2E9E4E3E1A5E1E8E3E7E4E5E1E7E8E2E3A4E5E2E5E4E8E8E8E9E5A4E6E6E8E4E2E2E6E8E4E6E9E5E1E3E4E7E9E6E2E8E2E6E4E5E8E5E4E8E9E7E8E4E8E5W4E8E4E8E5W5E1E4E2E2E2E9E9E1E7W8E8E7E6E7E3W1A3
W4E8E7E5E1E8A1W6E5E7E9E3W2W6E3A5W4E2E3E3E2A7E6E8A2E9E2E4E5W5W9E1E3E4A7E9A1E9E4E4E9E2A6W9E4E5A5E2E3E6E7E4E1A1E9W1E5E9E4W2E1E9E5W8E2E3E3W2E9E1A2W5A6E9W5A8E7E1A2E7E8E9E6E9E9E5E4E6E8E9E9E2E9W5E9E3E2E7E2E3
E6E3W8E8E3E2W3E4E7E8E8E3E1E3E4A9E8E4A3E9A2E6E3E9E4E2W8E1E2E6E6W2E4E1E1E2E9E1E7E2A6E5E7E8E4A4E6E3A9E4A7E4E4W4E9E4E9W4E8E5E1W9W8E1E3W6E8E4E7E3E6E7A6E3E9A7E6E1A3W3W1E6E2E6E2E1E5E7E5E7W9E7W9E3E5E8E4E5W9E9
E1E1E3E7E4E1W3E7E7W9E2E5A4E1E5A7E3E1E3E7E6E6E8E6E2E6E3E3E1W3E9E8E1E7W1E9A7E4W4A2E7E3E7A7A7E7E1E9E8E6E2E4E8E7E1A1E3E2W5E8E6E7W1E7E3E8E4W6E9A6E3E6E6E3E2E4E1E1E9E7E5E1E7A3E9W3E3E1E1A9E1E9E4E6E9E8E8E2A3E8
E2E6E1E1E2A3E8E4E5E3E7E8A2E2E1E4W4E5E1E1E4E1E9A9W2E2E1E9E4E2E5E2E8E1E3E2E7W6A9E2E1E5W1E1E3E3E4E3E6E8E8E4E4A8E4E5E7E6E5E1E9A9E9E1E7E6A8E9E5W2E4E4E5E6A5E5A1W4W9E5E4E9E2E5E3E9W5E8E5W8E8E8E9A1E4A4W1E1A4E8
E8E1E8E9E5A8E1W2E7A9E4E3E7E9E4W1E7E4E2E5W2E8E9E8E8E8W4E6E2E6A1E2E5A2E4E2W7E1E8E9A8E7A2E9E7E8E5E6E3E5E3E2E3E3W3E6A2E1W7E9E5E6E8W1E1E6E6W4E4E4E2E5E9E4E1W4E4W5E8E2E6E7E4E2E6E2E8W3E8W6E4E7W3E1E4E9E2E3E7A8
E2W9W2E5E8E7E7E7E2A9E7E9E3E2E7E9E7E3E6W3E3E7E4E7E6E7E5E7E5E3E7A5E2E3E3E9E9W2E2E9W1E1E9E1E2E3E1E8E8E5W3E3E9E7W4E9E6A8W1E1E1E8E9E6E1E9E1E4E5E1E8E5E4W9E4A2E1E9A5E8E6W6A9E7E9E7E4E4E2E4E8E3W6E3E7E1A4E4W7E1
E7E6E3E2E8E3E8E2E1E2E1E3E8E9E2W8E3E7E4E2E3W7A2E7W3E4E2E3E8A5E8E1E1E2E4E5E3E5E7E3E3E9E6E1E8E5E4A5E3E2E6A5E1E5E2E4E6E2E6E5E2E8W7E7E3W7E2W2W2E8E6E1E1E9W4E3E2E5E8A2E2A6E5E6E6A8E6E3A6E5E3E7A2E8E3W2W6E1E8E6
W1E5E8E7E7E5E1A8E3E6E4E2E2E4A1E8W4E5E8E3E5E3E8E7E5E2E8E9A7A8A8W9E6A8E6E9E7E3E5W3A4E5E7E8E4E3E9E5E5E2W7A5E5E8E2E5E7E1E3E8E2E4E9E5E8E3E7E1E7E2E5E9E5W9E7W8E5A9E7E4E3E4W7E4E9W2A8A8E5E1E5E7E6E1A3E2A9E3A1E5
E6E4E1E6E6E9W8W2E8E6E9E7E1A3E8E6A4E6E8E2E3W3E6E7E4E1E6E7E1E7A8E7E9E2E2E7E5E5E4E1E6E4E5A7E2E3E2E3A5E7E6E5E3E4E4E3A6E8E1E5E9A1E9E5E8E2E6E5E4E6E9W4E6A1E8E1E7E4E8A9A2E1E5A9E7A2E2E9E9E7E2E6E8E5E9A7E8E5E1E3
E9E5E7E9E7E8E1E4E9E5E5W6E3E1A9E1E8E7E1E8A8E9A4E6E7A1E4A1E5W2E6E4E1W2E5E7E2E9E6E5E8E4E7E7A2W2A1W3E7E9E5E9E1E7E4E2E6E8E7E3E9A6E4E3E3E8E5E1W1E3E6E4E8E7E4E2E8E2E1A7E8E6E4A3E9W4E8E2E3E2E5E6E1E4E5W7E5E9E3E7
E2E4E3E9E1E4W7E4E5E6E1A7E7A9E7W3E7E4W4E6E4E8E9E6E8E7E3E2E1E7E8E4E4E7E1E1E3A8E2E3E1E4E1W8E7A9E4E4E4E4E9E5E2W8W5E9E8E2E4E1E6E9E8E5E7E6E4A7A8E4W4E9E9E7E2E9E1E9E2E2E3E5E4E5E9E6W8E5E9E6E4E8E5E4E4E9E3E1E4E8
E9E5E2E1E8E9W6E9E5E4E9E7E7E8E3E1E1E1E9E3E5E6E9E5E1E7A7E4E9E4E7E5E7E7E3A5E2A3A8E6E7E7E9E5E6E5E5E5E1E2E4E9E9E6E5E1E6E3E6E7E3W6E5E8E4E2E9E5E9A9E5E9E6E3E9A4E6E1E5E1E7E9E3E6E9E1E9E7W9W3E5W2W8E7E5E9E2E4E5E8
E6E2E9A7E6W1E6E3E5A9E3W1E6W7E7A3A5E8E2E4E8W2E4E3A3E2E8E9E9E3E1E2E8E5E1E5W2E5E1E6E3W7W4E2E2E2E6E9E7E3W6E8E1E1E4A1E3E5E2E5E2W4E4E7W5E5E6E5E7E4E6E5E3E9E1E7W9E9E5E3W7E5E7E4E9E3E3E5E7E1A5E4E4E8E9W2E1E2E2W6
E8A5E2E1W2E4E7W3E1E8E3E2E7E9E7E9E3A6E1E2E7E2E5E6E7E1W7W5E4E1E9E2E5E1E5W6E6E3E7E9E9E8A1E1E1E4E9E6E9E8E6E6W3E2W1A4E9E7E9E8W2W4E7E1E5E3E7A1A6E9E6E4A1E2A1E7E8W5E7E7E7E9E4E9E5E2A3E9E9E1E8E4A1E8E5E7W4E3A7E3
E8W2W8A1E8E6E2E7E6E1E4E3E5E4E1E8E6E5E3W4W2A2E2E1E4E3A5E5E6E2E3E4E1E8E2E8W6E1E7E1E9W6E9W7E7E8A1W9E6E7E8E1E4E8E3E5E5E6W6E8E9E8E3E8E2E6E7E2E8W6E4A8E2E3E9E7E3E3A2E4E3E4W3E1E8W1E7E2E8E7W7E8E3E3W5E2E5E6E9E2
E8A6E1W7E8W8E2E6E2W2E6E1E6E3E8E3E2E2E9E3E7E1E5E7W4E9E3E7E4E2E1A4A7E4E9E4E5E3E4E7E2E1E6E2A1E7E1E6E2E2E1E1E8E4E7E1E5E1E6E2W8E8E3W6E5A8E8E2E1E7E9E8E1E7E4E3E7E6E6E6E1A7W5E9E7A7A2W2E5E5E3E9E2E5E4E1E6A5E3E2
W1E1E5E5E8E9E8E9E8E5E5E8E8E8E9E3E1A2E5E3E8A6E3E2E8E5E3E3E1W8E9E8E9E2E9E3E8W3E3E6E1E8E5E5E7E3E4E6E1E5A9E9W6E6E4E2E8E2E7W9E8E3E4E7E5E9E1E8E4E1E9E7E7E8W7E6E7E6E3E6E7E3E9E7E4E7E3E8E3E7E1A9E4E6W3E5E3E2E6E3
E1E8E3E3W1E8E1A6E7E6E4E2E5A5E6E5W5E5E9E1E1E1E2E8E8W1E6E4E7E8W7E9E6E4E3E3E1E7W6E4E6E9E4E4E2E6W5E7E7E9E9A6E3E8A9E3E6E6E4E2E7E5E1E5E6E4E9E8W1E1E8E4E2E9E3E6W6E1E5E7W3E9E1E6E7E8A4E3E4E1E7E3E4E2E7E4E2A5E9W5
E5A8A4E6E9E5E9A1E6E8E2E6E3E7E1W1E2E8E8E9E1E3E7W8E1W1W5E3E3E9E4W5E9A5E5E7W8W8E6W3E7E6E5E4E1E6E1E7E7E6E8E9E3E4A5E8E2W7E7E3E2E4E5E9E5W5E4E8E8E9E1E2E4E9E3W9E8W2E6E4E9W6E6E8E6W7E9E2E5E8E1E5E6E8E2E5W8E7E3E6
E7E3A2E5E3W1E9E5E7E7E9E9E5E7E2E3A4E9E6E7E7E1E6A6E8E6E7E2E4E3E6E3E5E5E7E7E8E6E2W9E3E7E1A4E4E3E8E7E5E6E1E4E2A1E5E7E5E3E5E6E5A5W4W1W3A8E5E7E1E7E7E3E1E6E4E3E9E5E3E9A2E4E8E1A6E5E7E5E9E4E8E7E8E8E5E5E9E2E8E3
A3E2E9E5E2E4E2E7E8E1E4E7E4E8E9E4E9E5E7E5E7E2E4E9E9E2W7E9E2E7E2E3E2E9W6E2E5A4E4E8W2E6E8E5A5W8E4A4E5E9E1E6W1E5E6E3E5E3E8E5E6A4E8E4E6E9E5E1E3E7E9E3E9E2A1E4E5E5E3E2E6E3E7E3E9E3E2E9E6E2E1A8E2E8E4W5E2W2W7E5
E7E9A7E7E1E9E4W5E9E3E9E7E4W5E6E8E6A6E1E8E1E6E5E4E8E6E1E8W4W9E9E1E5E3E9E4E6E1E4E1E9A6E4E5A1E5A3E1E6E5E3E6E2E6E8E8E7E1E6E6E6E3E9A8W6E7E1A4E1E3E8A4E8E3E7E6W5E4E5W5E5E3E2E1E3E3E6E4E4E6W1A4E4E3E2E3E4E3E4E6
E7A7W4E7E9E8E9E9E7E4E9E5E4E4E9E3E2E3E8E4E1E3E6E5E4E4E5W9E5E4E3E5E6A9A1E2E8E6E3E7E6E2E2E4E7E1E7E1A9E8E4W2E2E3E2E9E4A3E2E9E3E4E9E5A4E5E1E9E8E5A1W5E6E9E5E4E2E5E9E2E7E6E3E2E8E9E9W6E1A3E1E3E6E5E4E5E9E8E8E3
E7E3E5E1E4E8E6E1E6E4W7E1E8E6E8A9E1E1A6E5E7E4E7E7E7E4E7E1W2W2E8E9E8E7E2E6E6E3E1A8E3E5E6E3E8W3A2E8E9E2E5A9E2E7E4E9E9W5E4E9E9E2E2E7E5E3A7E1E8E8E8A3E2E1E9E7A6E9E4E7E7E8E1A9E4E5E3E7E7E3E9W2E3E5A4E7A6A6E4E9
A9E6E9E4E1E2E8E4E6E7E1E4E2E9E8E9E3E9E8E6E3E1W3E3E9E8E2E4E2A1E5E2E6E2E8E4E1E4E8E7E5E8E1A2A6A2E8A2E8E8E6E4E8A1E5E8E6E4E5E6E2E4W6E6E8E7E4A7E3E8E6E3E6E1E1E4E4E4E6E6A7E8E2E2E3E8E6E8E9W6E5E4E8E6E9E2E3E1E7E2
E9E4E1W8E9E8E3E6E1E2A6E7E4E6E4A5A4E3E5E5A3E5E4E8E2E9E4E8E1W6E7E6E1E2E3E3E8E7E5E8W5E2E2E2E8E6E8E1W6E3E3E6E7E2E9E3E8E1E5E6A4W9E1E5E3W1E1E6E5E7W1E9E5E5E1E6E8E4E2E3A9E6E9E5E9E9E9E6A9E4E1E7E3E7E4E7E5E1E5E8
E4W8E9E2E5E7E9A3E8E8E6E4E9W1E1E4W8E5E4E8E2E7W4E6E2E4E8E8E5A4E3W8E6W3W7A6A6E3E5E9W7A3E9W3A4E4E7E2E4E8E2E2E2E8E6E4E8E8E9W8E2E5E7A3E7E5E3E2E1E5E1A9A9A5E7E1E9E7E3E4W3E8E2E4A5A9E6E5E3E5E1E2E6E3E7E5E6E5E9E2
E3E2A5E5E9E7A5A6E9E8E3W9E8E3E2E6E8W8E3E3W8E8E6E6E7E9E8E7W5E3E5E4A7E1E6E2E9E1E2E7E8E2A4E1E3E8E1A1E3E1E4W8E1E9E5E8E5W9E9E3E8A2E7W2A6E6E3E9E8E6E8W2E9E1E7E2E3E4A8E5E8E4E9E9E1E7E9E9E6E8E9E3E6E8E2E7A7E9E1E8
E5E3E8E1E8E4E3E2W4W1E7E2E9E3A1E5E3W8E9E7E6W1E1A9E5E8E4E3E3E9E9E5E3E9E7E8E2E2E9E6E2E9E9A6E8E1E9A5E1E7A1E3E7E2E6E1E6W3E7E1E7E1W5E1E2E6E1A9E8E4E2E5E4E4E6E8E3E5E7E1E9E3E9E5E3E8E7E5E3E8E5E4E9E3E1E9E1E8E1E7
E8E9E6E9A2E2E1E5E5E9E7W1E8E4E9E9E6W5W3E4E5E1W6E3E8E1E1E4E6E8E7W1E4E9E9E2E2E9A6E5E3E7W4A4E6E1E5E3E5E1E7W7E8E4E3E5E3E5E3A7E8E2E3E6E3E4E1E2A3E9A8E7E7E2E8E3E5E4E6E6E2E7A1E3E4E3E2W3E6E5E3E5A3E8E5E1E9E9E9E8
E7E1E3E9E1E4E7E7E4E5W2E3W1E5E8E2E8E6E4E4E2E6E8E5E4E5E5E7E2E8W4E9E8E4E8A4E1E5E9W6E1W6E6A6A3E8A8E4E3E4E9A2E4E5E9E9E6E4E7E9W4E7E9E9E8E9W4W7E1E9E4W3A5E3E9W3E4A7A1E6E6A2E1E5W4E7E1A1A3E5W6E2E9E5W6E5E5E6E7E9
A8E2E7E7E9E1E3E2E4E1E2E9E4A4W3E3E1E4E9E3E5E2E1W9W5A2E4A7E8E4E4E2E7E7E6E6E1E4W2E2W1E9E6A9A2A9E5E8E2E4E9E7E7E2E5E6E8A8E9E5E6E2E2E7E3E9A5E8E6E4E1E3E4E5E9E5E7E6E3E8E7E1A6E3W3E3A2E3E1E9E9E6E6E8E9E6E4E7E9W4
E2E9E9E2E8E8E2E1E8E8A3E9E8E5E4E3E6E3E3E8E7A3E9E4E7E6E1E7E8E3W4E7E2E6E8E3E8W2E3E7E4E7E9E3E4E8E4E5E3E9E6E9E7E9E4E5E6E8A9A8E2E4E5E6E8E7E4E2E4E1E3E8E3E7E5E4E6E7W6W7A2E4E8E9E6E8E7A4W7E8A6E5W9E2E1E7W1W1E4E4
E1E8A1E1E9E5A9E5E6A5E1W9E1E3E5E3E3E1E3A7W3E4E8E7E7E1E6E3E8E1A3W8E9W8E8E2E9E3W8E3E2A4E6E6E4E7A9E4E7E5A6E4E5E6E7E7W1E8E6A2E6E9E2E9E1E6E2W3E9W2E8E7E1E3W8E9E1E3W9E3E5E6E5E4E9E1E6E3W6E7E6W1E9E6E8E2E6E1E6E9
E8E5E2E4E3E7E6A8E1W8E2W7A5A5E9E8E9E2E4E2E5E7E4E8E1W3E2E7E1W5E2A3E1E4E4E1E7E9E7E9A8E1E3A7E2E1E1E3E9E5E9E2E9E5E8E2E2E8E4E6E7E2W9E9A1E1A8W9E8E1E8E8E5E6E2E2E6E9E8E2E6E8A8A3E9E8E3E9E3E2E3E1W4E7E5E8E3E4E3E4
E2E8E2E2E2E9W2E7E7E6E8E2A1E5E1E8E5E2E8E3E7E3E1E4E4E8E9E5E2E3E5E4E7E1E3A1E7E6E4W4E6E3E9E3E8E9E2W7E5E1E6E9E5E5E3E8E5E4E8E8E2E5E5W9W6E1E2A2E3E1E1E6E1E5W8E2E8E9E5E6E6E4E5E4A7E9E3E4E1E6E9E1A2E1E4E9E8E2E4W7
E9E6A2W2E2E7W7E7E7E5E7E9E2A2E6E4E5E2E1E4E4E4E1E2E5E4E3E5E3E1E6E7E5E9E8E8E7E2E7E6E8E5E4W8E6E6E6E7E9E1E2W6A5E7E9E8A9E6E9W3A8E5E7E1E7E5E8E9E1E6E3W6E7E9E4E5E8A1E7E2E9E9E1E3E9E5E3E1E4E5E5W6A5E4E3E1E5A7E9E7
E1E3E5E6E4E5E6E8E2E8E7W7E1E5E5E5E4E6E7W6E8E5E4A1E5E4E3E5E5E8E7E5A9E9E9E1E1E6E6E1W2E9E7E6E3E2E8E5E2E9E8E2E1E3E2E6W9E7E5E9E1E3E4E4E2E7E3E3E1E4E7A1E6E9E2E3E3E2E8E1W3E7W8E7E3E8A2E3E4E5E4E3E2E6W7E5E7E5A9E2
E4E3E1E6W2E6E7W8E1E9W8W7E3E2E5E7E8E3E1W4E2E1W6E6E6E1A8E1E4A5E2A4E5E5E2E6E3E7E5E8E4E2E1E8E1E1E4E5E1E4E5E7W1E8E6E8W6E2E3E8E4E3W1E4E4E5E4A9E4E6E8E5E4E5E2E6E5A9E8E5E9E1E2E1E9E7E8E9E3E3E3E7E2E6E5E9E1E3E5E2
E9W5E4E5E4E4E6E7W9E6E3E8E5W8E8E8E8E5E5E8A8W1E5E7E7E5E8E4E4E8E5E5E7E3E2E4E4E3W4E6E9W1E9A8E4E8W5E6W8E7E6E7E8E7E4E3E8E6E9E2W5E7E5E5E6E4E4E6E2E5E8E7E1E7E7E6E2E2E8E7E4W8E2E2E2E4E3E6A5E8E1E6W4E1E3E8E7W8E6E4
E7E4E9E4E9E7E8E4E5E2E5E3A2A6E1E5E9E9E9E9E4E1E7A6W7W8E5E6E1E6E1E8E2E1E8E4E8E7E6E7A1E2W2E4E1E7E2E2E5E6E7E8E5E4E2E4E8E9A8E6E9E4E6E6E5E5E5E7E8E2E1E1E4W4E9E8E3A6E1A8W7E2E2E6E5E2E3E3E5A3E8E6E7E8E2E2E4E5E4E1
E7E1E9E1A4E8E6E9E2E8E7E7E4E9E7E9E1E5E6E4E6W6A9E4E6E7E5E7E7A6E6E3E5E4E4W6E8E1E2E3E1E4E4E6E5W5E7E9E4E2E3E9E5W4E3E6E3A9E2E3E8E8E8E9E6E7E5E3E9E3A2E7E4W6E1E6E5E9E4E7A9E4E5E8E7E8E8E2E8E9E2E8E6A6E2E6E7E8E4W8
W6E5E7A1E9W9E6E7A1E7W9E2E3E8E1W6E3E7W5W8E3A6E1A6A5E8E3E7E1E8W6E3E9W2E6E9E4E6E1W3E4E7E1E1E2E7E6W9E6E3E1E5E6E9E9E8E9E4W2E4W8E2W6A3E3E8E5E9E5E6E2E9E6W5E3E3W8E4E4E1E5E8W7E4E9E8E9A3E3E4E5E7E3E3E6E2W2E6E3E5
E6E7A4A6E6E6W7E9A9E6E7E2E5E8E2E1A4A4E3E9E4E4E4E5A6E5E3E3E8A9E1A5E2E2E2E4E5E1E3E3E7E8E3E3E5E4E7A5A8E2E3E2A1E2E9E1A7E3E8E6E9E9E5E4E9E7E3E6E5E7E1E5E9W8E7E8E7E1E2E1E9E8E7E3E6E4E6E6E6E4E3E5E8E8E5E5E9A5E5E3
E6E4E5W5E3E6E6E3E9E9E3E3E1E8E7E7E1E7E4E7W3E8W1E2E5W3E6E6E5E5E4E5E4A5E3E9W4W3E9E2E8E1A3E1E4A4E7E6E1E4E6E4A1E5E1E5E8A6E4E2E1E1E3E4E5E9E8E5E9E9E6E9E5E7A3E8E2E9E2E9E3E3E1E9E1E6E2E6E1E1E4A4E8E7E4E5E2E2E9E4
E5E9E8W8E1W3A4W2E4E1E7E5E6E1E6A3E8E4E2E9W1E1E8E3W6E6E5E7E6E9W2A4A6E9E4E1E1E7E1A7E2E7E8E3A6E3E5E7E4E4E7E4A6E6A7E2E5E7E8E6E4E1E1W7E5E3W4W1E9E3W5E1E4E8E1E4E7E9E6E5E9E7E2W2A7E8E1E1E3E5W5E9E4A3E2E5W8E7E1E3
E6A9E3E3E9E4E4E8E2E3E4E9E4W6E6E7E7E5W5E3E1E6E9W1E5E7E8E8E6E4E4E8E5E8E2A9E3W4E9E4E8W7A4W3E9E7E1A6A8E5E4E3E7W6E6E2E2E1E6E8E1W8A1E2W9E7W6E1W4E1E1E6E5E9E4E9E7E2A2E6E4E1E7E5E2E5A5E4E5E5E4E6E1E4E5E8E6E2E8E1
A4E4A2E2E5A9E8E7A5E7E7W6E9E9E1E7W9E2E6E4E4E8E1W5E3E8E3E8E6E8E4E5E7E1E1E3A4E8E7E5A3E7E4E3E8E8W8E8E3E4E4E5E2E3E1E7E6E1E5W4E9E9E9E1E1E8E8E7A1E7A4E7E4W8E8E6E8E7E5E1E1E1E1E6W5W8E8E8E6E3A6E1E9E9E1E7E5A1E7E7
E4E7E9E6E7E5A8W2E9E6E4E7E9E4E8E1A3E5E9E4E9E1E6E1E3E3E6E1E3W4W8E7E2W7E4E7W9E3A1E3E8E9E4E9E2E4E8E9E7E9E3E6E8A4E4E4W4E5A1E5E4E7A5A7E4E3E8E2E4W4E2E2E2E1A9E5E2E6A4W5E9E2E3E6A2W3E6E9E4E2E5E9E7E3E3E8E9W3E6E2
E5E2E5E4E6E5E2E8E7E2E1E5E9E1A6E4W1E3E2E9E1E1A7A7W3E8E6E2E8E7E5E5E4E5E3E4E7E3E4A3E8W3E4A8E4E5E6A8E2E3E9E5E1E2E6E1E3E2E6E4E6E3A7E5E8W6W7E8E9E5E4E8E2E3E3A3E7E9E1E8E5E8A4E3E1E1E4E4W2E4E4E5E3E9E1W7E9E9E9E2
E2E8E4E5E7W5E9E1E2E1E3E5E8E9E5E6A1E5E2E3E1E7W9E3E9E7E6E4W1E8E4E9E2E3E8E3E7E7E3E1E8E4E2A9E9E6E7E6A3E9E4E7W5E8E5E6E2E5W6E3E2E9E9A4E7E6A3E2A5E8E2E3E4E7A5E6E8E5E9E1E3A1W1E6W3E8E1E5E5E7E9E3E6E2E7E5E9E1E5E4
A2E2E9E3E7E4E9E1E5E5E3E3E9A2E3E7E2E5E3W1E9E4E2E6E3E2E4E9E7E7E3E9E1A8E4E7E6E6E9E2W1E7E8E1E6E5E7E5E3E2E8E7A8W2E1E7A5E4A9E9E8E6E8E8A6E8E6E8E7E8E5W4E9E5W6E3E5E5E9E1A8E8E6E2W9E3E8E1E8A2E9E3E3W3E3E5W3E5E9E9
E3E2E4E8E7E3E4W9E3E9E6E6E3E7E5E9E8W7E3A2E9E2E6A3E8W7W2E6E9E9E4E8E1E1E5E6E2E7E1E6E9E1E5E8E2E1E8E4E9A2E8E5E5E3E3E2E1E5W1E6E1E1E9E3E2E8E9E5E1A4E8E3E3E7E5E1A4E2E2A2W1E8E9E8E1E1E3E1A3E5E6E4E4E3A4E9E4W1A2E4
E4E2E3E3E9E2E8W4E6A2A4E3E7E3E5E3E4E5E9A1E4E3A2E9E8E3E3W4E1E8E7E5E8E2E4E2E2E5E9E6E8E8E7E1E5E7E9E3A1E6E7E7E7E2A8E1A8E6E8E6E5A5E9A3E3E5E3E9W9E2E5E7A1W4E3E3E4E2E3A4E6E6E8A6A9E3E9A8E9E9A6E7E6E7E2E7E9A4E7E4
E7E1A2W1E1E9E8W9E5E5E2A2W3E6E9E8E3E9E1E2E3A4E6E8E7E6E5A3E6E4E8W8E5W9E4E2E9E5E4E9E7E8E2E5E2E5A9E5E4W6E1E7E1E5E1E1E6E9E3E5E3E8E7E4E8E9E3E2E8E9A2E4E7E6W3W4E1E7E6E9E4A1E5E9E5E7E4E8E1E8A8E7A5E8E4E3E2W3E7E6
E9W9E3E8E2E2E7W4E5E4W4E7A3E2A2E4E7W7A9E8E9W8E3W1E1E2A6E9E3E9E1E5E9E9E4E6A6E5A2E7E6E4E3E2E9E5A8E4W7E9W4W7W6E3E8E9E3E4W4E2E1E8E2E2E7E1E7W1E9E3E8A3W8E8E1E1E6E5E2E7E7E8E3E7E3W9E3E6E5A2E7E7A3E7E5E9E6E5E3E2
E9E8E7E9E5E8E7E6E7E6E8E2E2W9E8E3E3W1A3E8E3E3E6E1E5E8E1A3E3W6E5E5E2E8E6A5E6E3E3W4E3E5E6E1E5E1E6E8E9E4A5E4E8E6E2E9E9E2W9E7E2E9E5E6W6E9E1E6E6E8E5W6E1A4E2E9E9E4E9A6E8A9E3W6E8E9A4E9E1E1E4W6E3E3E2A3E4E9E3E9
E8E9W6E3E3E3E2E9E7E6E4E9E7E9E1E9E9E9E6E9A3E6E2E8E1E8E6E7E8E3E1E8E3E4E6E3E9E4E4E3E6E7A2E5E6E4E7E6E1E1E7E8E3E8A5A8E6E5W9E6W2E1E1E1A5W1W5E7W7E5E1E4A5E3E5E6E7E9A8E3A4E7E3E5E3E7A1E5E4E8E4E5E5E7E5E5E8A3A4E3
E2E2E3E8W5E8E9A6E4E9E3E5E1E8E7E7W4E5E6E8E1E6A8E1E2E5E2E6E5E1E5A6A6E5A6E2E8E2E3E9E8E5E3E7E4E9E5A9E3E6E7E3A4E4W6E7E2E9E2E9E2E7E3A5E7E3W5E5E7E3E2E9E9E5E8E9E2E7E5E3E2E7E6E7W6A2A8A9E4E3E5E9E9E3E2A9E9E5E4E9
W5E2E6E5E3E2E2E3E2E4E6E8E1E5E3A4E1E3E2E6E8E4E6E6E6E1W2E3E8E4W8E7E9E2W5E2E3W2E2A3E7E9A5E6E5E6E7E4E3A4E7W3E8E2E2E4A4E6E4E3E5E5E5E4E3E8E1E8E1E2A6W7E4W9E1W9E9E5E7E4E7E3E2E3A3E1E4E2E5E8E1E4E6A6E2A1E6E5E3W5
W4W5E9E3E2E9E3E1E9E2E6E7E3E9E4E6E1E1E6E4A1E7E7W9E7W1E6E6E7W9E5E6E4E6A9E7E5E9E5E2A1E7E8E9E9E3E7A8W2E1E8E3A9E6E3E6E3E9E4E4E7E3E6E9E9A8E3E9E7E7E9E6E3E2E9E3E6E9E7E7E1E1A2E4W9E6E9E8A6E3W4A7W2W9E5W5E2W4E3W5
E1E6E2E4A8W4E8W9E8E8A3W6E8E4W2E9A6E2E9E2E5E7E7E3E3W3E6E8E9E9W1W5E5E2E1E9E2E2E4E2E1E7E9A5A1E6E3E6E6E5E3E4E4E6E8E7E1A9E9E6E8E4W4E7E7E7E1E7E1E8W5E7E6A7E3E2E4E9E7E4A3W7W9W8E1E6E6E6A4E3E6E2E8E5E1E8W6E9E7E4
E5E1E6E9E2E1W4W1E5E7E9E3E8E4E3W9E6E6E1A2E9E4E9E6E3E8E4E5E4E8E2E1W8E9A5E7E9E2E1E3E2E9E6E4E3W9E9E5E5E9E3E9E9E5A9E7W6A7E2A1E6E3E9E3E8E1E8E1E1E3E9E6E5E4E2E7A1E5E6E5E9E6E7E2E7E9E1E4E9E6E7E4E3W4W4E4E8E7E5E7
E9E4E4A4W6E6E2E8E5E7E4E2E1E9E3E1E6E9E2E2E3E3E6E1E1E5E9E8E4E7A6E8E9E7E1E2E6E6A1E8E1E6E9A5E2W7E9E2W7E5E2E2W3E3E5E4E1E3A1W4W2E6E5E4W8W8E1W6E8E1E8E4E5E5E9E5E8E1W3E1E6A8E5E6E5E1E8A7E2E9E8E2E6W4E8E9A8E5E8A4
E3E9E2E9E6E9W5A1E9E3E1E1E7W6E3A4E4E6E1E5E4E7E4E5E1A1E2E8E2E1E7E3A2E2E4E8E3E2W5E9E9E9A9E2E4E9E8E3E8E1E2A8E8E4E9E9E3A5E5E7E5E9E6E3E4E3E2W6E1E7E7E4E2E1E2E3E1E5E1W8E7W3E1E7E9W5E9E7A1E8A7E1E8E7E3E4E2E5E6A7
E8E8A6E9E1E6E8E6E7E5E9E3E8W5E5E6A9E6E2E9E6E9E5A2E8E3E3E4E4E6E2E9W6E6E1E8E1E6E1E3E6E5E5E3E6E3E7A3E1E6E8E5A5E3E9E4E6E7E9E8E7E2E3E9E7E7E9E6E4E7E4E6E4W8W3E7E3A4E9E5W5E9E2W5W8E6E5E2E2E5E2A6E4E7E8E2A7A5E7E8
E5E8E6A6E1E2E5E4E5E8E1E5E5E1E1W4W1E4E9E8W8E1E7E9E4W4E1E1E1E2E5E9E9E3E1E9E7W1E5W1E3W1A5A4E5E1E3E9E2E6E2E3E6E6E3E6E5E6E6E7A2E1E6E2E7E5E2E8A3W4E4W3E1E1A2W3E2E8A4E2E4E8W5W8E6E3E1W5E7E1E2E3E5E7E1E4E3E8E8E9
W3E7E6E1E4E8E2W5E5E1A2E9E8E4E7E3E8E4W5A2E2E9E1E8E3E3E4E6E3E2E6E8E6E6E4E4E3W7E9E6E9A2E3E5E4W6E5E2E3E6W9E4E7E4E7E6E1E4W2E8E1A9E6E8E5E7E8E2E3E1E7W6A6E5A9A6E2A8E2E9W8E4W4E9E3E1A6E5E7E8E1A1E3E9W5E1E8E5E9E4
E5E4W1E6E4E7E6W3E3E5E9E2E9E6E2E2E3E9E8W2E8W4E3W8E2E2E1W9E5E4E8E1E6E9A2E8A8E3E2E2A3E1A5E7W6W7E2E5E2A2A2E7W8E5E5W3E6E9E1E4W6E6E4E8E3E2E8E9W9E5E8E2E6E7W3E2E1E4E7E6E9E4E7E4E8E6E9E6E5E4A5A4E8E5W6E8E8E7E1E8
E7E8E2A8E4A4E4E2E1E1E6E6E1W6W3E7E3E3E4E2E2E7E7E3E4E8E8E2E3A5E8E1E5W2A9E1E3E3E3E6E4E1E7W5E2E5E9W7A4W7E8E3E7E9W7E3A6E8E8A8E2E8E5W8E1E3E2E9E3E2E2E9E7E9E4E4E1W1E4E2W6E9E4E8E2E5A9A2E6E7E4E4E7E6E3E7E1E9E6E5
W5E5E2E7E2A2E6E6A8E1E7E1E4E7E1E9E3E6E1A5E8E6E4E3A6E8A6A4E2E8E3E1E1E8E8W4E8A9E7E8E8E1E4E9E2E1W8E4E5E3E8E3E4E6E9E6E3E7E6E7E2A6E4E6A7E1E4E7E4E7E5E6A6E4E7E9E6E7E7W2E4E6A6E6E3E1E3E4E4E2W8E7E6E7E8E4E9E9E2E6
E6E3E3E5E5E4E6W9E6A1E6E4E9E3E7E9E8E7E8A3E4E2E9E8E9E7W1E9E4E2E1A4E6E5E3E8E3E1E6E5E4E8E7E1E7E3E5A4W4E7E1E3E3E4E6E9E4E6E3W9E7E6W6E9E8E6E1W1E5E6E5E9E2E6E7E4E7E8E7E7E2A7E7E5W3E7E7E1A2E6E6E2E7E2W9E1E1E4E1E6
E6E6E2W1E6A3E1A9W7E7E9E1E1E5E4E9A9E7E7E4E4W2E1E7E5E1E4E6E8E5W1E2E6E7E9E9E3E7W7E6E2E6E5E8A8E7A9E8E4W1E4E8E9E9E8A5E3E7E7E2W2E5A5E3E8W5A6A1E8E5W4E7E9E2E4E6E9E7E6A1A5E7E9E3E2E5E8E2E2E5W2E6E7W4W4E4A5E1A8E9
E1E9E7E2A1E2E4E2E4E7A4E3E6E8E1W8W5E8W7E6E4E4E4W3E5E8E7E8E8E9E3E5E9E7E7E7E3E5W7W5E2E4W4E5E6A1E9E7E7E9E5A1E3E3E9E4E1E2E7A5A8A6E9E8E6E2A3E8E5W3A8A8E3E7E5E3E9W5E8E6E7E6E5E1E5E9E4E1W5E3E8E6A9A6E4W5E1E5E6E1
E3E3E7E1A1E2A4E2E6A3E5E5E3W4E7E1E3E4E4E3E5E5E4E9E4E6E4W6E4E6W1E6E8E3W1E6E3E1E7W5E5E8W3E3E6E8E7E4E6W3E9E3A4E2E4E5E7E4E5E2E1W6E6E8E7E2A5E9E8W4A1A3E8E9E3E7E2E6E3E3E3E6E4E2E7A2E9E7E9E3A1E3E1E3E7E2W3A6E8E5
E3E4A9E8E9E5E5E4E1E7W2E6E7E2E6W7E2E1W9E3W4E5W3E4E9W3A2E8E2E6W2A7E9E5E2E9E7E6E3W7E3A8E7E2E1E6A7E5W8E1E4E3E8E5E9W7E4E4E8A3E3E1E4E4E5W6E5A5E7E2E1E6E2E5A8E9E9E2W1E5E7W7E7E6E6E1W3E6E9E6E6W5E3E6E9A4E3E5E2E9
E9E9E7W9E5A4E9E3E2E1E4E6E9E5W5E9E5E3E9E2A1E2E9A1W2E4E1E2E1E2E5E8E1W4E6E2E5E5E2E8E7E9W2A9E4E3E1A7E9A5E5E2W7E6E7E4E4W8E9A5A3A9E2E1W9E5A5A6E9E6E8E7W9E6A4A5E8E2A9A9E3E4E5E7E1E6E6E3A4E2E1E2E3E3E8E4E9E7E4E1
E5E7E6W7E4E9E5E1E6E4E9E9E1E3E7E3W4W8E9E3E9E4E7W1E1E9A2E7W7E8E7E6E3E8E3W7A3E3E8A4W2E5E9E4E2E3A9E9E5E7A8A7W4E8E2E9E8E2E8E2E9E1E2E9E6E2E2E4E2A7E4A4E8E9E2W9E8E5E9E1E9E9E3E5E5E8E3E8W4E2E9E2A9E5E4E4E6E9E5E7
E6A9E5E8E2E2E2E4E7E1E2E8E5E6E2E9E6E2E6E9E2W1E7E2E2E8E5E5E3E1E7E3E4E2E5A3E3E5E6W6E8E4E8E1E7E4A9W4E2W3A6E9E8E9E3E9E6E6E5E2A4A2E4E5E4E4E6E9E9E3E7A2W5E4E5W3E2E1E5E6E4E3E3E3E2E1E5A6A4E9E7W4E8E8E3A8E4E6A6E6
W7W6E7W4W4W5E9A3E1E5E3E9E4E2E2E2E6E2E8E7E7E3E2E6E1E9E8E2E6E6E7E3E9E5E6E5W4E7E8E8E1W9E5A8E2E3E3E9E4E8E2E6E9E5E3W1E8E2E5E2E2E7E9E4E8E7E6E6E5E4W6W5E7E4E9E3E1E3E8E7A9E1E4E4E8E8E7W5E5W7E1E6E9E4E9E5E4W4E9E5
W5E8E6A6E7E9E1E5E2E4E5W6E2E1E6E6E6W7A6E2E1W9E6A9E4E5E5E1E7E4A7A5E1E1E8E2E1E8E3E5E5E1E3E5E2A7E4E1E7E9E9E7E7E1E3E2E4E5E2E8E7E4E5E4E9E4E3E2E4E4E9E6E6E2W8E3E1E2E9E9E9E8E4E3E2E5E2E5E6E3E6E5W2E4E6E5E3E5W8A1
E1A9A6E7E8A4E6E5E9E2E9W3E5W6E3E8E2W7A9E7E3E8E6E2E2E7E1E9E8E5E4E3E9E5E4E5E8A3E1E2E3E6E6E1A1E4A7E3E6E6E6E5E2E9E2E1E1E2E6E2E1E4E6E8W9E6W8E5E1E7A9E3E9E6E5E3E4E6A5E5E8E5E6W5E4E9E4E3A1E3E2E8E1E8W5E2A2E8E2E6
E7E8E8E8E7E4E9E1E7E3E5E9E4E8E4E2E1E6E5E9A6E2E8E8A6E3E4E5E4W2W9E7E4E6E2E8E5E2E6W9E9E3E3E2E5A9E9E7E3E1A1E3E3E1E6E8E1E5E6E8E9E1E6A6W2W5E4E1E6A6E3E6E9E5E5E6E6E5E8A4E3E2E3E7E6E3E7E4E2W2E8E2E7E6E4E3E9W4E5E7
E3E4A3A4E1E7E7E7E8E9E4E5E3E6W5E2E7A3E9E6E4E9E7E3E5E4E2E5W1E4E2E8W2E6E1E1W3E9E3E3E7E6E9E1A3E9E7E1E8E5E7A3E9E3E5E4E8E5A5E1E3E5E1E7E1E9E8E7E8A4E1E8W8E3E6E7E7A3E8E9A2E7A8E6E9E7A4E9A8E9E6E5A4E3E3E8E8E3E6W7
E1E7W9E4E9W1E1E3A2A5E3E7E8E4E1A2E2E5E7E9W4E4E1E7W5E5E8E6E3E1E7E9A8E4W6E9E1A3A1E1E8E1E1A5E5E4E1E1W7E4E3E4E3E6W5E6E5E8E8A9W8E1E9A8E5E3E4W8W1E2E2W9E8E8A3A9A1E5W8E8A6E8E3E4E1E8E4E8E7E7E6A5E8E8E7E8W9E3A1E8
E2A9W4E3E3E9E2E2E3E3E5E5E9E2E9E4E7E1E2E9E8W1E5E8E9E5E4E8E1W2E6E9E7A9E5E2W7E8A5E4E4E4E3E6A8E3E2E8E1E9E7E4E3E5E2A1E5E7E3E8E4E5E8E6W5E7E8E4E3E3E6E6E9E5W3A5E5E9E8E1E5E1E1W9W8E3E8W5E9E3E7E8E6E8E5E6E9E2E4E5
E8E3E4E1W4E6W2E1A8W7E9E8E5E8E8E2W2E7E2W1A1E3E3E1E6E4E4E9E9A4E7E7E6E1E3E7E3E3E6E2E9W1E2E6E3E1E1E2E3W7E8E7E9E6A4E9E6E1E3E4E4E4E5E8E2W8E9E2E6E9E9E3E6E3E2E5W4E1E7E9E3E5A6E3A5E5E5E8E4E3E3E1E4E3E6E7E8A3E4E2
E4MME1E7E1E6E1E5E4E3A9W3E4E3E8W7E3E2E9E6A5E5A4E8E7E5E3E7E7W8E7E7E6E3E2E7E5W7E6E3E5E7E5E6E6E2E9E7E5E5E8E3E1E4A7E8E6A9E2A3E1E8E3W5A4A1A5W2E6E4W6W8A5E6E2E8E6A3A6E5E8E3A2E8E2E2E5E9E8E9E8E8E3E3E2E7E8E6W5E8
E5W1E6E4E1E6E8E5E1W2W9E3E4E6W2A1E5W2E3E8W6E7E1E4E1E3E2E3W2W8E1E4E3E8E3E1E8E1E8E1E5E2E3E4E7E3E1E9E5E5E7A8A2E5E7E3A1W4E8A1E1E7E3E3E9E6E4E8E6E9E5E3E8E5A6E9E4E5E8E5E7E9E8E2A2E8A8E5A1E8E1E7E1E9E2A5E8E4E3E3
A4E4E9E7E2E7E5W1W3A4E4E2E9E2E6E2E1E5A1W8E1E9E3E5E5A9E9E8E7E5E7W1E1E1E2E6E4A2E3E3E9E1E9W1E2E1E7E4E4E5E7E5W6E1E6E3E3A4E7E1W1E9E3E4E1E6E4W4E2E4E1E9E4E2W5W4E3E6E1E2E7E5E9E7E4E9E4A3E8E1E9E8E7E4W9E3E4E6E5E5
